ATGGGTGCGAGTCCGGTGT -> TGGGTGCGAGTCCGGTGTG
GTAACCCGATTGTTTACCG -> TAACCCGATTGTTTACCGT
TTGCCTTTCATTTTCCGTC -> TGCCTTTCATTTTCCGTCC
GACTAACTAACGAGGTGTA -> ACTAACTAACGAGGTGTAC
GAGTAAGGATTACAGCGAC -> AGTAAGGATTACAGCGACC
GGCATTTGTAGACCGTTAT -> GCATTTGTAGACCGTTATT
GAGTAGATGGTTGCCTTAG -> AGTAGATGGTTGCCTTAGC
AGCAAGTGAGTCTCAATAA -> GCAAGTGAGTCTCAATAAA
CCCGGCCAAACGGGGTCAG -> CCGGCCAAACGGGGTCAGC
ACGATGCTGTGACAGCGAG -> CGATGCTGTGACAGCGAGC
TCTTTCGGGTCGCGGGGGC -> CTTTCGGGTCGCGGGGGCT
ATATCCGGCACTAGGCGTC -> TATCCGGCACTAGGCGTCA
ACCGTTATTTTTCAGGATA -> CCGTTATTTTTCAGGATAC
GATGCTGTGACAGCGAGCC -> ATGCTGTGACAGCGAGCCT
CCTGGGTGCCCATATCTGA -> CTGGGTGCCCATATCTGAG
TTCATTACAGCAGCGATCC -> TCATTACAGCAGCGATCCG
TAACGAGGTGTACTTCTAC -> AACGAGGTGTACTTCTACG
ACTGAAGAACTGATCTTCG -> CTGAAGAACTGATCTTCGC
CTTTATGACAACGAAGGGA -> TTTATGACAACGAAGGGAC
ATCGAACACTCCTTTAACT -> TCGAACACTCCTTTAACTC
CCGGCTTTGAACGCAATGA -> CGGCTTTGAACGCAATGAG
GGATGTCCAAGCTTCGCCA -> GATGTCCAAGCTTCGCCAG
CAGCAGCGATCCGTAGCAT -> AGCAGCGATCCGTAGCATC
CGGTGAGGAAGGCTTTATG -> GGTGAGGAAGGCTTTATGA
TTAACTCACGAGTTTCAAG -> TAACTCACGAGTTTCAAGT
TGGCGAGGGGAGAATGGAA -> GGCGAGGGGAGAATGGAAC
GACTACCAAAAGACAAGTT -> ACTACCAAAAGACAAGTTT
CGCATATCGGGTCGCGGGG -> GCATATCGGGTCGCGGGGG
ATATCTGAGTCTAGCCGTA -> TATCTGAGTCTAGCCGTAC
GAGGGGAGAATGGAACCAG -> AGGGGAGAATGGAACCAGG
CCTGTAGGATGTCCCTTGC -> CTGTAGGATGTCCCTTGCG
GTTGCCCAATACGATGCTG -> TTGCCCAATACGATGCTGT
AACTCACGAGTTTCAAGTT -> ACTCACGAGTTTCAAGTTT
GTTGATCCATCTCGTCCGG -> TTGATCCATCTCGTCCGGA
GATCCTATACGTCATCCGT -> ATCCTATACGTCATCCGTT
GTTAGGTACGCGCCGCACT -> TTAGGTACGCGCCGCACTA
CAAGTCCCTAGTTAGGATA -> AAGTCCCTAGTTAGGATAA
AAGCGCAGTCGTTGCCCAA -> AGCGCAGTCGTTGCCCAAT
TTCACTCTTCTTCATTACA -> TCACTCTTCTTCATTACAG
GCTACGCCCTGAGCGTTTC -> CTACGCCCTGAGCGTTTCG
GTTATGACACAGGTCGGTG -> TTATGACACAGGTCGGTGG
TTCTCGCCGGAAGCTAACC -> TCTCGCCGGAAGCTAACCG
ACTAGGCGTCAACTCACTC -> CTAGGCGTCAACTCACTCG
CGAGCCACTCATAGCGGGC -> GAGCCACTCATAGCGGGCC
GACGGCTTAAGGCTTGTTT -> ACGGCTTAAGGCTTGTTTG
GCTGGAGGATAACCCACTG -> CTGGAGGATAACCCACTGA
CCGACAAGACAGCGGGATT -> CGACAAGACAGCGGGATTC
GCCCGGCTGGAGGATAACC -> CCCGGCTGGAGGATAACCC
GTAGACCGTTATTTTTCAG -> TAGACCGTTATTTTTCAGG
TTGAGCCTTGCGCTCTACA -> TGAGCCTTGCGCTCTACAC
GCTCAAAGCGTCCGAAACA -> CTCAAAGCGTCCGAAACAG
TTTTTGCACCGCAGCCGTT -> TTTTGCACCGCAGCCGTTC
TCCGTATTCAAGTGTGTCC -> CCGTATTCAAGTGTGTCCG
ACCCTACTTTCATGGAATC -> CCCTACTTTCATGGAATCA
TACGGTCCTGGCCGGTCGG -> ACGGTCCTGGCCGGTCGGG
TTCGGTGTATAGGGATGTG -> TCGGTGTATAGGGATGTGG
CGAGCAGAATGACGGCTTA -> GAGCAGAATGACGGCTTAA
TACTCTCTTTGCCGACGAC -> ACTCTCTTTGCCGACGACA
CCAAAGTCCCCACTTGCTT -> CAAAGTCCCCACTTGCTTC
ATGCAAGTCCCTAGTTAGG -> TGCAAGTCCCTAGTTAGGA
GGAGAATGGAACCAGGCGT -> GAGAATGGAACCAGGCGTC
CTTCTTCATTACAGCAGCG -> TTCTTCATTACAGCAGCGA
ACCCCCAGCTCCCGCTTAT -> CCCCCAGCTCCCGCTTATA
CATCTCGTCCGGAACCTTG -> ATCTCGTCCGGAACCTTGC
AGACGATCGAACACTCCTT -> GACGATCGAACACTCCTTT
ACAAACACAGCTCCAGCTC -> CAAACACAGCTCCAGCTCC
CTATTTGATTTACTCTCTT -> TATTTGATTTACTCTCTTT
GGCGGTGCGTTGGGGCTGA -> GCGGTGCGTTGGGGCTGAG
GGGGGCTACCCATGTAAGA -> GGGGCTACCCATGTAAGAC
TTCTGGCCGATCAGCACAC -> TCTGGCCGATCAGCACACC
TCTGCTCAGAGCCCTAAGG -> CTGCTCAGAGCCCTAAGGA
TTTGGAGCCTGACATCGCC -> TTGGAGCCTGACATCGCCT
CTTCTCGCCGGAAGCTAAC -> TTCTCGCCGGAAGCTAACC
CTAGGAGAATGTGAGCTAA -> TAGGAGAATGTGAGCTAAC
GCCGGAAGCGCAGTCGTTG -> CCGGAAGCGCAGTCGTTGC
CTATCTCCGACAAGACAGC -> TATCTCCGACAAGACAGCG
ATAGTAGTTAGACGCTTAG -> TAGTAGTTAGACGCTTAGC
AAGTTTCGACTTAAGCCCG -> AGTTTCGACTTAAGCCCGT
CTTTCAGATCAGGATCAGC -> TTTCAGATCAGGATCAGCT
AAGCTTCGCCAGCTCCCGC -> AGCTTCGCCAGCTCCCGCT
CATTTTCCGTCCCGGCCAA -> ATTTTCCGTCCCGGCCAAA
CGTTGGGGCTGAGGCTAAG -> GTTGGGGCTGAGGCTAAGC
AACACTCCTTTAACTCACG -> ACACTCCTTTAACTCACGA
AGCGTTTCGCGCAGAGCAA -> GCGTTTCGCGCAGAGCAAG
GACAAACACAGCTCCAGCT -> ACAAACACAGCTCCAGCTC
CAGTCGGGTCGCGGGGGCT -> AGTCGGGTCGCGGGGGCTA
GACCGGTAATGGCGGTGCG -> ACCGGTAATGGCGGTGCGT
TTCAGGATACCCTACTTTC -> TCAGGATACCCTACTTTCA
TGGGTGCGAGTCCGGTGTG -> GGGTGCGAGTCCGGTGTGG
TGCTCCGTATTCAAGTGTG -> GCTCCGTATTCAAGTGTGT
GCGGGCCATTCAGCCTGGG -> CGGGCCATTCAGCCTGGGT
CTCGAACAAACGATCAGCA -> TCGAACAAACGATCAGCAT
TAAGAAGTATCGTACCTCC -> AAGAAGTATCGTACCTCCG
TACTCGTTCTGCCCGCTCC -> ACTCGTTCTGCCCGCTCCT
AACAAACGATCAGCATAGT -> ACAAACGATCAGCATAGTA
AAATCAGGTAACCCGATTG -> AATCAGGTAACCCGATTGT
CTTTGGAGCCTGACATCGC -> TTTGGAGCCTGACATCGCC
ACCGGTAATGGCGGTGCGT -> CCGGTAATGGCGGTGCGTT
TCAAAACGGTTCCATAAGA -> CAAAACGGTTCCATAAGAG
TGGTAGGTTGATCCATCTC -> GGTAGGTTGATCCATCTCG
GCACTAGGCGTCAACTCAC -> CACTAGGCGTCAACTCACT
TACCGGCTCTTTCGGGTCG -> ACCGGCTCTTTCGGGTCGC
TGCGTTAGGCTTTTTGCAC -> GCGTTAGGCTTTTTGCACC
CGAGTTTCAAGTTTCGACT -> GAGTTTCAAGTTTCGACTT
GGCTGAGGCTAAGCGCGAA -> GCTGAGGCTAAGCGCGAAT
ATGCACTGGGCGTGTAACG -> TGCACTGGGCGTGTAACGT
TGACACAGGTCGGTGGATA -> GACACAGGTCGGTGGATAC
AATTGTGCTCCGTATTCAA -> ATTGTGCTCCGTATTCAAG
CATTACAGCAGCGATCCGT -> ATTACAGCAGCGATCCGTA
GATGAAGTAAATTGAGAGT -> ATGAAGTAAATTGAGAGTC
ATTTTTCAGGATACCCTAC -> TTTTTCAGGATACCCTACT
TAGACGCTTAGCAAGGGTT -> AGACGCTTAGCAAGGGTTC
GTTTCTGGCCGATCAGCAC -> TTTCTGGCCGATCAGCACA
GTCTGATCTCCATCACTTC -> TCTGATCTCCATCACTTCA
AGATCAGGATCAGCTACTC -> GATCAGGATCAGCTACTCT
ATGAGATCCTATACGTCAT -> TGAGATCCTATACGTCATC
GTTATTTTTCAGGATACCC -> TTATTTTTCAGGATACCCT
AGAGTCTGCTCAGAGCCCT -> GAGTCTGCTCAGAGCCCTA
TAAGGAGAGTAAGGATTAC -> AAGGAGAGTAAGGATTACA
CTCTTTGCCGACGACAGGT -> TCTTTGCCGACGACAGGTG
CAGAGCCCTAAGGAGAGTA -> AGAGCCCTAAGGAGAGTAA
ACTCACTCGTTCGAGATAT -> CTCACTCGTTCGAGATATG
GAGATCCTATACGTCATCC -> AGATCCTATACGTCATCCG
ACAAGTTGCGGTGAGGAAG -> CAAGTTGCGGTGAGGAAGG
CCCGGAGCCTGGACAGTTT -> CCGGAGCCTGGACAGTTTG
AGAGAGAGACAGAAATCAG -> GAGAGAGACAGAAATCAGG
TTAAAACTCGCAACTAAAT -> TAAAACTCGCAACTAAATA
CCCTTGCGAGACGCCTGGG -> CCTTGCGAGACGCCTGGGC
ACTCGCCAACACAAGTTGC -> CTCGCCAACACAAGTTGCG
GCGGGGGCTACCCATGTAA -> CGGGGGCTACCCATGTAAG
TGCCAAACATTAGATGAAG -> GCCAAACATTAGATGAAGT
TCGGTGGATACGAATAGTT -> CGGTGGATACGAATAGTTT
TCGCCAACACAAGTTGCGG -> CGCCAACACAAGTTGCGGT
GTCCCTTCAAGCACAGCTA -> TCCCTTCAAGCACAGCTAG
TTTGCCTTTCATTTTCCGT -> TTGCCTTTCATTTTCCGTC
ACTACCTGGAGCAGCTTCT -> CTACCTGGAGCAGCTTCTC
TACATGGGTGCGAGTCCGG -> ACATGGGTGCGAGTCCGGT
AAGCTCTATTTGCCTTTCA -> AGCTCTATTTGCCTTTCAT
TTCGCCAGCTCCCGCTTAT -> TCGCCAGCTCCCGCTTATA
AGCACAGCTAGTCTTTAAC -> GCACAGCTAGTCTTTAACG
GTCGAAAAGAATAGCCCAA -> TCGAAAAGAATAGCCCAAA
CCAACATTTATAGCTGCTA -> CAACATTTATAGCTGCTAA
AGCCCAAAGTCCCCACTTG -> GCCCAAAGTCCCCACTTGC
ACCTGGGCTTTGGAGCCTG -> CCTGGGCTTTGGAGCCTGA
CCATAGTCAGTACAGGACC -> CATAGTCAGTACAGGACCT
AACGTCTGATCTCCATCAC -> ACGTCTGATCTCCATCACT
ACGACCGTCGCATATCGGG -> CGACCGTCGCATATCGGGT
AGGACTACCTGGAGCAGCT -> GGACTACCTGGAGCAGCTT
CAGCCTGGGTGCCCATATC -> AGCCTGGGTGCCCATATCT
CACCTGAGATGCCAAACAT -> ACCTGAGATGCCAAACATT
GAGCAAGTGAGTCTCAATA -> AGCAAGTGAGTCTCAATAA
TCCCGCTTATACGGTCCTG -> CCCGCTTATACGGTCCTGG
TTCGACAGAGAGAGACAGA -> TCGACAGAGAGAGACAGAA
AACTCACTCGTTCGAGATA -> ACTCACTCGTTCGAGATAT
ATGACAACGAAGGGACCGA -> TGACAACGAAGGGACCGAG
AAGTGAGTCTCAATAAAGT -> AGTGAGTCTCAATAAAGTA
ACTCACGAGTTTCAAGTTT -> CTCACGAGTTTCAAGTTTC
GGTCGTGAAACCAAGCTCT -> GTCGTGAAACCAAGCTCTA
CCGTTCACACCTGAGATGC -> CGTTCACACCTGAGATGCC
GGTGTACTTCTACGGAACC -> GTGTACTTCTACGGAACCA
ACGATATCCGGCACTAGGC -> CGATATCCGGCACTAGGCG
GTACAGGACCTGGGCTTTG -> TACAGGACCTGGGCTTTGG
TAGTCTTTAACGACTTGCT -> AGTCTTTAACGACTTGCTG
CCGGTCCCTTCAAGCACAG -> CGGTCCCTTCAAGCACAGC
CCTCCGGACTAACTAACGA -> CTCCGGACTAACTAACGAG
CCGGTAATGGCGGTGCGTT -> CGGTAATGGCGGTGCGTTG
GCAGGCGGCAGTCGAAAAG -> CAGGCGGCAGTCGAAAAGA
GCCTTTCATTTTCCGTCCC -> CCTTTCATTTTCCGTCCCG
AGCTGTCGACTAGGAGAAT -> GCTGTCGACTAGGAGAATG
AAGGACTTGACGATCGCTA -> AGGACTTGACGATCGCTAA
AGCCCGTACCCCCAGCTCC -> GCCCGTACCCCCAGCTCCC
GGTCCCTTCAAGCACAGCT -> GTCCCTTCAAGCACAGCTA
TCCATCACTTCACTTAAAA -> CCATCACTTCACTTAAAAC
GCTGTCGACTAGGAGAATG -> CTGTCGACTAGGAGAATGT
AAAAGACAAGTTTCACTCT -> AAAGACAAGTTTCACTCTT
AGTTTCCAACATTTATAGC -> GTTTCCAACATTTATAGCT
ACTTGACGATCGCTAAGGC -> CTTGACGATCGCTAAGGCA
GACTTAAGCCCGTACCCCC -> ACTTAAGCCCGTACCCCCA
GGGTGCGAGTCCGGTGTGG -> GGTGCGAGTCCGGTGTGGT
AGATGGTTGCCTTAGCAGC -> GATGGTTGCCTTAGCAGCC
ACTCGTTCGAGATATGCAC -> CTCGTTCGAGATATGCACT
ATGCCAAACATTAGATGAA -> TGCCAAACATTAGATGAAG
GCTTATACGCTTGTTATCA -> CTTATACGCTTGTTATCAG
TACAGCGACCGGTAATGGC -> ACAGCGACCGGTAATGGCG
TCATAGCGGGCCATTCAGC -> CATAGCGGGCCATTCAGCC
AAACACAGCTCCAGCTCCC -> AACACAGCTCCAGCTCCCG
ATTTTCCGTCCCGGCCAAA -> TTTTCCGTCCCGGCCAAAC
GCTAAGGCAGTCATAAGGT -> CTAAGGCAGTCATAAGGTT
CCGGAAGCTAACCGTCCGG -> CGGAAGCTAACCGTCCGGA
CTGAGTCTAGCCGTACGCT -> TGAGTCTAGCCGTACGCTT
TACTCGCCAACACAAGTTG -> ACTCGCCAACACAAGTTGC
GGGTGCCCATATCTGAGTC -> GGTGCCCATATCTGAGTCT
TATGCACTGGGCGTGTAAC -> ATGCACTGGGCGTGTAACG
GGCTTTATGACAACGAAGG -> GCTTTATGACAACGAAGGG
CGTGCGTCCTTTCAGATCA -> GTGCGTCCTTTCAGATCAG
CACAGCTAGTCTTTAACGA -> ACAGCTAGTCTTTAACGAC
GGTCGGGTCGCGGGGGCTA -> GTCGGGTCGCGGGGGCTAC
CTACACCGCGTAGACGATC -> TACACCGCGTAGACGATCG
GCGTTGGGGCTGAGGCTAA -> CGTTGGGGCTGAGGCTAAG
CAAATTGTGCTCCGTATTC -> AAATTGTGCTCCGTATTCA
GTAAATTGAGAGTCTGCTC -> TAAATTGAGAGTCTGCTCA
TACGGAACCAGCTCCCGCT -> ACGGAACCAGCTCCCGCTT
CTTGCGCTCTACACCGCGT -> TTGCGCTCTACACCGCGTA
GTACTGTTCTCGTTATGAC -> TACTGTTCTCGTTATGACA
TGTGACAGCGAGCCTCCTC -> GTGACAGCGAGCCTCCTCG
AGGATGTCCCTTGCGAGAC -> GGATGTCCCTTGCGAGACG
ATGGCGGTGCGTTGGGGCT -> TGGCGGTGCGTTGGGGCTG
GTTTCGCGCAGAGCAAGTG -> TTTCGCGCAGAGCAAGTGA
TAGACGATCGAACACTCCT -> AGACGATCGAACACTCCTT
AACGGTACATGGGTGCGAG -> ACGGTACATGGGTGCGAGT
CTGCTAAGAAGTATCGTAC -> TGCTAAGAAGTATCGTACC
CGGCTTAAGGCTTGTTTGG -> GGCTTAAGGCTTGTTTGGC
GACAGAAATCAGGTAACCC -> ACAGAAATCAGGTAACCCG
ATGAAGTAAATTGAGAGTC -> TGAAGTAAATTGAGAGTCT
GCGGTGCGTTGGGGCTGAG -> CGGTGCGTTGGGGCTGAGG
ACCACGATATCCGGCACTA -> CCACGATATCCGGCACTAG
GTGGCAAATTGTGCTCCGT -> TGGCAAATTGTGCTCCGTA
GAGCAGCTTCTCGCCGGAA -> AGCAGCTTCTCGCCGGAAG
GAAGGACTTGACGATCGCT -> AAGGACTTGACGATCGCTA
TACCCCCAGCTCCCGCTTA -> ACCCCCAGCTCCCGCTTAT
GGTGACGATCGCTCAAAGC -> GTGACGATCGCTCAAAGCG
GGGCTACCGCCGCTACTCT -> GGCTACCGCCGCTACTCTG
CGTTCAAAACGGTTCCATA -> GTTCAAAACGGTTCCATAA
TCAGCACACCGTCAGCCCG -> CAGCACACCGTCAGCCCGG
CTTGCTGTGGCATTTGTAG -> TTGCTGTGGCATTTGTAGA
GTCTTTAACGACTTGCTGT -> TCTTTAACGACTTGCTGTG
CGATCGAACACTCCTTTAA -> GATCGAACACTCCTTTAAC
GCCATTATCGGTGGCGAGG -> CCATTATCGGTGGCGAGGG
TTGCTTCGTTACTCGTTCT -> TGCTTCGTTACTCGTTCTG
TACCACGATATCCGGCACT -> ACCACGATATCCGGCACTA
TAGCATCCCTACTCGCCAA -> AGCATCCCTACTCGCCAAC
AGAACTGATCTTCGCTCCC -> GAACTGATCTTCGCTCCCT
AGTCTAGCCGTACGCTTAG -> GTCTAGCCGTACGCTTAGA
TTACCCAAGAATCTACTCG -> TACCCAAGAATCTACTCGA
CAGCCGTTCAAAACGGTTC -> AGCCGTTCAAAACGGTTCC
GCTTAAGGCTTGTTTGGCA -> CTTAAGGCTTGTTTGGCAC
TCAGTCGGGTCGCGGGGGC -> CAGTCGGGTCGCGGGGGCT
ATACGCTTGTTATCAGTCG -> TACGCTTGTTATCAGTCGG
AAGTCCCTAGTTAGGATAA -> AGTCCCTAGTTAGGATAAG
AACGCAATGAGATCCTATA -> ACGCAATGAGATCCTATAC
TCGCGGGGGCTACCGCCGC -> CGCGGGGGCTACCGCCGCT
ATCCCGGAGCCTGGACAGT -> TCCCGGAGCCTGGACAGTT
CAGCTCCCGCTTATACGTA -> AGCTCCCGCTTATACGTAC
ATAGTCAGTACAGGACCTG -> TAGTCAGTACAGGACCTGG
CGGAGCCTGGACAGTTTGG -> GGAGCCTGGACAGTTTGGA
TGCCTTAGCAGCCGGCCGG -> GCCTTAGCAGCCGGCCGGA
TACACCGCGTAGACGATCG -> ACACCGCGTAGACGATCGA
CTAGGAGAATGCGTTAGGC -> TAGGAGAATGCGTTAGGCT
ACGGAACCAGCTCCCGCTT -> CGGAACCAGCTCCCGCTTA
GCGTCAACTCACTCGTTCG -> CGTCAACTCACTCGTTCGA
TTTGATTTACTCTCTTTGC -> TTGATTTACTCTCTTTGCC
CTTATACGCTTGTTATCAG -> TTATACGCTTGTTATCAGT
ACTGGGCGTGTAACGTCTG -> CTGGGCGTGTAACGTCTGA
CTGTAGGACTACCTGGAGC -> TGTAGGACTACCTGGAGCA
GATCAGCATAGTAGTTAGA -> ATCAGCATAGTAGTTAGAC
ATACGACCGTCGCATATCG -> TACGACCGTCGCATATCGG
GAAGCGCAGTCGTTGCCCA -> AAGCGCAGTCGTTGCCCAA
CTCTGTAGGACTACCTGGA -> TCTGTAGGACTACCTGGAG
GTCCCTTGCGAGACGCCTG -> TCCCTTGCGAGACGCCTGG
AGCCTTGCGCTCTACACCG -> GCCTTGCGCTCTACACCGC
TACGTCATCCGTTTGTTGG -> ACGTCATCCGTTTGTTGGA
TCAAGTTTCGACTTAAGCC -> CAAGTTTCGACTTAAGCCC
ATGTGGCAAATTGTGCTCC -> TGTGGCAAATTGTGCTCCG
TGTCCCTTGCGAGACGCCT -> GTCCCTTGCGAGACGCCTG
TCGCTAAGGCAGTCATAAG -> CGCTAAGGCAGTCATAAGG
AACGAGGTGTACTTCTACG -> ACGAGGTGTACTTCTACGG
CGGTGCGTTGGGGCTGAGG -> GGTGCGTTGGGGCTGAGGC
GGAGTGACAAACACAGCTC -> GAGTGACAAACACAGCTCC
GATAACCCACTGAAGAACT -> ATAACCCACTGAAGAACTG
AAATACCTGGGGAGTGACA -> AATACCTGGGGAGTGACAA
GTCGGGTCGCGGGGGCTAC -> TCGGGTCGCGGGGGCTACC,TCGGGTCGCGGGGGCTACC
GGACCGAGCAGAATGACGG -> GACCGAGCAGAATGACGGC
AACGGGGTCAGCAGGCGGC -> ACGGGGTCAGCAGGCGGCA
CAGGACCTGGGCTTTGGAG -> AGGACCTGGGCTTTGGAGC
CTACCTGGAGCAGCTTCTC -> TACCTGGAGCAGCTTCTCG
GGGCTGAGGCTAAGCGCGA -> GGCTGAGGCTAAGCGCGAA
TTACTCGTTCTGCCCGCTC -> TACTCGTTCTGCCCGCTCC
TGCGAGTCCGGTGTGGTGC -> GCGAGTCCGGTGTGGTGCC
ATGCCGGTCCCTTCAAGCA -> TGCCGGTCCCTTCAAGCAC
TGGAATCACACACAAGGAG -> GGAATCACACACAAGGAGC
GAGCCACTCATAGCGGGCC -> AGCCACTCATAGCGGGCCA
CGCTCTACACCGCGTAGAC -> GCTCTACACCGCGTAGACG
GGCTCTTTCGGGTCGCGGG -> GCTCTTTCGGGTCGCGGGG
CCCGATTGTTTACCGTTCA -> CCGATTGTTTACCGTTCAC
TTTATGACAACGAAGGGAC -> TTATGACAACGAAGGGACC
AAAAGAATAGCCCAAAGTC -> AAAGAATAGCCCAAAGTCC
GATCAGGATCAGCTACTCT -> ATCAGGATCAGCTACTCTT
TGAAGAACTGATCTTCGCT -> GAAGAACTGATCTTCGCTC
AAGAATCTACTCGAACAAA -> AGAATCTACTCGAACAAAC
ACAGCGAGCCTCCTCGGTG -> CAGCGAGCCTCCTCGGTGG
AGCTACTCTTGAGCCTTGC -> GCTACTCTTGAGCCTTGCG
GCTAAGAAGTATCGTACCT -> CTAAGAAGTATCGTACCTC
TTTCAAGTTTCGACTTAAG -> TTCAAGTTTCGACTTAAGC
GGTTGCCTTAGCAGCCGGC -> GTTGCCTTAGCAGCCGGCC
TACCGCCGCTACTCTGTAG -> ACCGCCGCTACTCTGTAGG
ACGTCTGATCTCCATCACT -> CGTCTGATCTCCATCACTT
TCTATTTGCCTTTCATTTT -> CTATTTGCCTTTCATTTTC
TGTAGGATGTCCCTTGCGA -> GTAGGATGTCCCTTGCGAG
GCGGTGAGGAAGGCTTTAT -> CGGTGAGGAAGGCTTTATG
GAATGCGTTAGGCTTTTTG -> AATGCGTTAGGCTTTTTGC
AATCACACACAAGGAGCTG -> ATCACACACAAGGAGCTGT
GGCCGGTCGGGTCGCGGGG -> GCCGGTCGGGTCGCGGGGG
AGATATGTGGTCCCGTGCG -> GATATGTGGTCCCGTGCGT
TTGACGATCGCTAAGGCAG -> TGACGATCGCTAAGGCAGT
CAGCTACTCTTGAGCCTTG -> AGCTACTCTTGAGCCTTGC
TCACACACAAGGAGCTGTC -> CACACACAAGGAGCTGTCG
ACGCCGCCATTATCGGTGG -> CGCCGCCATTATCGGTGGC
CGGACTAACTAACGAGGTG -> GGACTAACTAACGAGGTGT
CATCCCTACTCGCCAACAC -> ATCCCTACTCGCCAACACA
GTTAGACGCTTAGCAAGGG -> TTAGACGCTTAGCAAGGGT
GTTATCAGTCGGGTCGCGG -> TTATCAGTCGGGTCGCGGG
TCCCTTGCGAGACGCCTGG -> CCCTTGCGAGACGCCTGGG
GTTCGAGATATGCACTGGG -> TTCGAGATATGCACTGGGC
CTCGTCCGGAACCTTGCTT -> TCGTCCGGAACCTTGCTTC
GCAGCGATCCGTAGCATCC -> CAGCGATCCGTAGCATCCC
CCGGCCGGAAGCGCAGTCG -> CGGCCGGAAGCGCAGTCGT
CCGGATTCATGTCATGCCG -> CGGATTCATGTCATGCCGG
TCGGTGGCGAGGGGAGAAT -> CGGTGGCGAGGGGAGAATG
CTCCGTATTCAAGTGTGTC -> TCCGTATTCAAGTGTGTCC
TGCTAAGAAGTATCGTACC -> GCTAAGAAGTATCGTACCT
GCAATGAGATCCTATACGT -> CAATGAGATCCTATACGTC
GTTCTCGTTATGACACAGG -> TTCTCGTTATGACACAGGT
TCCCGGCCAAACGGGGTCA -> CCCGGCCAAACGGGGTCAG
CCCTAAGGAGAGTAAGGAT -> CCTAAGGAGAGTAAGGATT
GTTTCACTCTTCTTCATTA -> TTTCACTCTTCTTCATTAC
GTCCCTAGTTAGGATAAGA -> TCCCTAGTTAGGATAAGAA
AAGAAGGACTTGACGATCG -> AGAAGGACTTGACGATCGC
TTATGACACAGGTCGGTGG -> TATGACACAGGTCGGTGGA
GCGTTTCGCGCAGAGCAAG -> CGTTTCGCGCAGAGCAAGT
GTCGACTAGGAGAATGTGA -> TCGACTAGGAGAATGTGAG
GTCAGTACAGGACCTGGGC -> TCAGTACAGGACCTGGGCT
TTCACACCTGAGATGCCAA -> TCACACCTGAGATGCCAAA
GTCGCGGGGGCTACCCATG -> TCGCGGGGGCTACCCATGT
CTGCTGAAGTACTGTTCTC -> TGCTGAAGTACTGTTCTCG
CTAACGGTACATGGGTGCG -> TAACGGTACATGGGTGCGA
TGTATAGGGATGTGGCAAA -> GTATAGGGATGTGGCAAAT
AGCCCTAAGGAGAGTAAGG -> GCCCTAAGGAGAGTAAGGA
GGTCAGCAGGCGGCAGTCG -> GTCAGCAGGCGGCAGTCGA
AACCAAGCTCTATTTGCCT -> ACCAAGCTCTATTTGCCTT
GGAAGCTAACCGTCCGGAT -> GAAGCTAACCGTCCGGATT
CTGTAGGATGTCCCTTGCG -> TGTAGGATGTCCCTTGCGA
ACCGGCTCTTTCGGGTCGC -> CCGGCTCTTTCGGGTCGCG
GGTTCCATAAGAGACGAGG -> GTTCCATAAGAGACGAGGT
ATCAGTCGGGTCGCGGGGG -> TCAGTCGGGTCGCGGGGGC
CTACGCCCTGAGCGTTTCG -> TACGCCCTGAGCGTTTCGC
CTATGTGATTACCCAAGAA -> TATGTGATTACCCAAGAAT
AAGCACAGCTAGTCTTTAA -> AGCACAGCTAGTCTTTAAC
TTGTACCATAGTCAGTACA -> TGTACCATAGTCAGTACAG
AGAATGGAACCAGGCGTCC -> GAATGGAACCAGGCGTCCA
CACTTGCTTCGAGTAGATG -> ACTTGCTTCGAGTAGATGG
ACCGCGTAGACGATCGAAC -> CCGCGTAGACGATCGAACA
TCTCAATAAAGTACTGAGC -> CTCAATAAAGTACTGAGCT
TGCTTCGTTACTCGTTCTG -> GCTTCGTTACTCGTTCTGC
GTTTCGACTTAAGCCCGTA -> TTTCGACTTAAGCCCGTAC
ATGTCCCTTGCGAGACGCC -> TGTCCCTTGCGAGACGCCT
ATTGTTTACCGTTCACACC -> TTGTTTACCGTTCACACCT
ACAGGACCTGGGCTTTGGA -> CAGGACCTGGGCTTTGGAG
GAGCTGTCGACTAGGAGAA -> AGCTGTCGACTAGGAGAAT
GCTCCCTGCTGAAGTACTG -> CTCCCTGCTGAAGTACTGT
CAGCTAGTCTTTAACGACT -> AGCTAGTCTTTAACGACTT
AGACAGAAATCAGGTAACC -> GACAGAAATCAGGTAACCC
ACTTCTACGGAACCAGCTC -> CTTCTACGGAACCAGCTCC
GTAAGGATTACAGCGACCG -> TAAGGATTACAGCGACCGG
CCATTATCGGTGGCGAGGG -> CATTATCGGTGGCGAGGGG
TGAACGCAATGAGATCCTA -> GAACGCAATGAGATCCTAT
CACGAGTTTCAAGTTTCGA -> ACGAGTTTCAAGTTTCGAC
CCGTACCCCCAGCTCCCGC -> CGTACCCCCAGCTCCCGCT
TGAAACCAAGCTCTATTTG -> GAAACCAAGCTCTATTTGC
ATACCCTACTTTCATGGAA -> TACCCTACTTTCATGGAAT
GATCGAACACTCCTTTAAC -> ATCGAACACTCCTTTAACT
CAGTTTGGACTACCAAAAG -> AGTTTGGACTACCAAAAGA
AACACAAGTTGCGGTGAGG -> ACACAAGTTGCGGTGAGGA
ACACAGCTCCAGCTCCCGC -> CACAGCTCCAGCTCCCGCT
GTGGTGCCTGGTCGTGAAA -> TGGTGCCTGGTCGTGAAAC
ACTACCAAAAGACAAGTTT -> CTACCAAAAGACAAGTTTC
GAATGGCTATGTGATTACC -> AATGGCTATGTGATTACCC
TAACGTCTGATCTCCATCA -> AACGTCTGATCTCCATCAC
CAGGCGTCCATTGCCACGA -> AGGCGTCCATTGCCACGAG
ACGGTCCTGGCCGGTCGGG -> CGGTCCTGGCCGGTCGGGT
ACCTGGGGAGTGACAAACA -> CCTGGGGAGTGACAAACAC
AGCGACCGGTAATGGCGGT -> GCGACCGGTAATGGCGGTG
CGACCGGTAATGGCGGTGC -> GACCGGTAATGGCGGTGCG
ATCACACACAAGGAGCTGT -> TCACACACAAGGAGCTGTC
ATGTGATTACCCAAGAATC -> TGTGATTACCCAAGAATCT
CACACACAAGGAGCTGTCG -> ACACACAAGGAGCTGTCGA
CAAGACAGCGGGATTCATG -> AAGACAGCGGGATTCATGC
TGTAAGACGTGTGGGACCT -> GTAAGACGTGTGGGACCTG
CTAAGTTTCTGGCCGATCA -> TAAGTTTCTGGCCGATCAG
GTCACCACGTTCCTGACAA -> TCACCACGTTCCTGACAAG
GTAGATGGTTGCCTTAGCA -> TAGATGGTTGCCTTAGCAG
CGCCCTGAGCGTTTCGCGC -> GCCCTGAGCGTTTCGCGCA
CGGCAGTCGAAAAGAATAG -> GGCAGTCGAAAAGAATAGC
CTGGGCGTTGAGTGGATGT -> TGGGCGTTGAGTGGATGTC
GTGTGGGACCTGTAGGATG -> TGTGGGACCTGTAGGATGT
GGAGAGTGGTAGGTTGATC -> GAGAGTGGTAGGTTGATCC
AGTACTGTTCTCGTTATGA -> GTACTGTTCTCGTTATGAC
CCAAGCTTCGCCAGCTCCC -> CAAGCTTCGCCAGCTCCCG
CAGCGATCCGTAGCATCCC -> AGCGATCCGTAGCATCCCT
GTGTACTTCTACGGAACCA -> TGTACTTCTACGGAACCAG
AGAATAGCCCAAAGTCCCC -> GAATAGCCCAAAGTCCCCA
CGCAGCCGTTCAAAACGGT -> GCAGCCGTTCAAAACGGTT
TGGCTATGTGATTACCCAA -> GGCTATGTGATTACCCAAG
ACGTACCGGCTCTTTCGGG -> CGTACCGGCTCTTTCGGGT
CAAACGATCAGCATAGTAG -> AAACGATCAGCATAGTAGT
CGGTTCCATAAGAGACGAG -> GGTTCCATAAGAGACGAGG
TTTTGCACCGCAGCCGTTC -> TTTGCACCGCAGCCGTTCA
TTGTTTACCGTTCACACCT -> TGTTTACCGTTCACACCTG
TTCTAAGTTTCTGGCCGAT -> TCTAAGTTTCTGGCCGATC
TCGTCCGGAACCTTGCTTC -> CGTCCGGAACCTTGCTTCG
ACGATCAGCATAGTAGTTA -> CGATCAGCATAGTAGTTAG
ACTCTGTAGGACTACCTGG -> CTCTGTAGGACTACCTGGA
CTAGTCTTTAACGACTTGC -> TAGTCTTTAACGACTTGCT
CCTTGCGAGACGCCTGGGC -> CTTGCGAGACGCCTGGGCG
GAGACGCCTGGGCGTTGAG -> AGACGCCTGGGCGTTGAGT
GGTGGATACGAATAGTTTC -> GTGGATACGAATAGTTTCC
TGTGGGACCTGTAGGATGT -> GTGGGACCTGTAGGATGTC
AGATCCTATACGTCATCCG -> GATCCTATACGTCATCCGT
TTTGTAGACCGTTATTTTT -> TTGTAGACCGTTATTTTTC
CTCAGAGCCCTAAGGAGAG -> TCAGAGCCCTAAGGAGAGT
TCTCGTTATGACACAGGTC -> CTCGTTATGACACAGGTCG
GGTGTATAGGGATGTGGCA -> GTGTATAGGGATGTGGCAA
ACGCCTGGGCGTTGAGTGG -> CGCCTGGGCGTTGAGTGGA
TATCGGTGGCGAGGGGAGA -> ATCGGTGGCGAGGGGAGAA
GAACAAACGATCAGCATAG -> AACAAACGATCAGCATAGT
GAGATATGCACTGGGCGTG -> AGATATGCACTGGGCGTGT
GGTGCGAGTCCGGTGTGGT -> GTGCGAGTCCGGTGTGGTG
GGCGTCCATTGCCACGAGT -> GCGTCCATTGCCACGAGTT
CCTTCTAAGTTTCTGGCCG -> CTTCTAAGTTTCTGGCCGA
GTAGGTTGATCCATCTCGT -> TAGGTTGATCCATCTCGTC
GTACCATAGTCAGTACAGG -> TACCATAGTCAGTACAGGA
GCTACTCTGTAGGACTACC -> CTACTCTGTAGGACTACCT
GTGCGTCCTTTCAGATCAG -> TGCGTCCTTTCAGATCAGG
CCGCTACTCTGTAGGACTA -> CGCTACTCTGTAGGACTAC
CCGTTCAAAACGGTTCCAT -> CGTTCAAAACGGTTCCATA
TAACCCACTGAAGAACTGA -> AACCCACTGAAGAACTGAT
TGAGCCTTGCGCTCTACAC -> GAGCCTTGCGCTCTACACC
CTTCTACGGAACCAGCTCC -> TTCTACGGAACCAGCTCCC
AGAGATATGTGGTCCCGTG -> GAGATATGTGGTCCCGTGC
GGATTCATGCAAGTCCCTA -> GATTCATGCAAGTCCCTAG
GCCTGGACAGTTTGGACTA -> CCTGGACAGTTTGGACTAC
ATAGCCCAAAGTCCCCACT -> TAGCCCAAAGTCCCCACTT
ATCCGGCACTAGGCGTCAA -> TCCGGCACTAGGCGTCAAC
AGCAAGGGTTCCAATAGGA -> GCAAGGGTTCCAATAGGAT
GTTAGGCTTTTTGCACCGC -> TTAGGCTTTTTGCACCGCA
CCAGCTCCCGCTTATACGC -> CAGCTCCCGCTTATACGCT
GCTAAGCGCGAATGGCTAT -> CTAAGCGCGAATGGCTATG
AGGTGTACTTCTACGGAAC -> GGTGTACTTCTACGGAACC
TAGATAGAGATATGTGGTC -> AGATAGAGATATGTGGTCC
AACTCGCAACTAAATACCT -> ACTCGCAACTAAATACCTG
TCATAATCCCGGAGCCTGG -> CATAATCCCGGAGCCTGGA
TCGTTATGACACAGGTCGG -> CGTTATGACACAGGTCGGT
GCCCATATCTGAGTCTAGC -> CCCATATCTGAGTCTAGCC
GGATCAGCTACTCTTGAGC -> GATCAGCTACTCTTGAGCC
TACGATGCTGTGACAGCGA -> ACGATGCTGTGACAGCGAG
ATAGCGGGCCATTCAGCCT -> TAGCGGGCCATTCAGCCTG
GGAGAATGTGAGCTAACGG -> GAGAATGTGAGCTAACGGT
TTGCGGTGAGGAAGGCTTT -> TGCGGTGAGGAAGGCTTTA
ATAATCCCGGAGCCTGGAC -> TAATCCCGGAGCCTGGACA
ACGCTTGTTATCAGTCGGG -> CGCTTGTTATCAGTCGGGT
AGAATGTGAGCTAACGGTA -> GAATGTGAGCTAACGGTAC
GCCTGACATCGCCTATAAT -> CCTGACATCGCCTATAATC
CAGAAATCAGGTAACCCGA -> AGAAATCAGGTAACCCGAT
AATGTGAGCTAACGGTACA -> ATGTGAGCTAACGGTACAT
CTGGCCGATCAGCACACCG -> TGGCCGATCAGCACACCGT
CCCATGTAAGACGTGTGGG -> CCATGTAAGACGTGTGGGA
CATAGTCAGTACAGGACCT -> ATAGTCAGTACAGGACCTG
CTCAATAAAGTACTGAGCT -> TCAATAAAGTACTGAGCTA
GTGTCCGAGCCACTCATAG -> TGTCCGAGCCACTCATAGC
TTCGACTTAAGCCCGTACC -> TCGACTTAAGCCCGTACCC
CTCGGTGGTTTTGGGAGCG -> TCGGTGGTTTTGGGAGCGG
ATGTCATGCCGGTCCCTTC -> TGTCATGCCGGTCCCTTCA
TACTCTGTAGGACTACCTG -> ACTCTGTAGGACTACCTGG
ATAAAGTACTGAGCTATTT -> TAAAGTACTGAGCTATTTG
GCTCCAGCTCCCGCTTATA -> CTCCAGCTCCCGCTTATAC
TGTAACGTCTGATCTCCAT -> GTAACGTCTGATCTCCATC
GCTGCTAAGAAGTATCGTA -> CTGCTAAGAAGTATCGTAC
CATTGCCACGAGTTAGGTA -> ATTGCCACGAGTTAGGTAC
CTTTCATGGAATCACACAC -> TTTCATGGAATCACACACA
GGAACCAGGCGTCCATTGC -> GAACCAGGCGTCCATTGCC
GCAGAATGACGGCTTAAGG -> CAGAATGACGGCTTAAGGC
AGGCTTGTTTGGCACGCCG -> GGCTTGTTTGGCACGCCGC
AGGCGTCCATTGCCACGAG -> GGCGTCCATTGCCACGAGT
TATAGCTGCTAAGAAGTAT -> ATAGCTGCTAAGAAGTATC
TGATTACCCAAGAATCTAC -> GATTACCCAAGAATCTACT
TTTTCCGTCCCGGCCAAAC -> TTTCCGTCCCGGCCAAACG
AAGCGCGAATGGCTATGTG -> AGCGCGAATGGCTATGTGA
CCCGCTTATACGCTTGTTA -> CCGCTTATACGCTTGTTAT
GGTGTGGTGCCTGGTCGTG -> GTGTGGTGCCTGGTCGTGA
CGCGGGGGCTACCCATGTA -> GCGGGGGCTACCCATGTAA
AGTCCCTAGTTAGGATAAG -> GTCCCTAGTTAGGATAAGA
TGTACTTCTACGGAACCAG -> GTACTTCTACGGAACCAGC
TCCTTTCAGATCAGGATCA -> CCTTTCAGATCAGGATCAG
ACAGCTAGTCTTTAACGAC -> CAGCTAGTCTTTAACGACT
GCGTTGAGTGGATGTCCAA -> CGTTGAGTGGATGTCCAAG
TTAAGCCCGTACCCCCAGC -> TAAGCCCGTACCCCCAGCT
AGGAAGGCTTTATGACAAC -> GGAAGGCTTTATGACAACG
ATAACCCACTGAAGAACTG -> TAACCCACTGAAGAACTGA
CGGGGGCTACCCATGTAAG -> GGGGGCTACCCATGTAAGA
TAAGCGCGAATGGCTATGT -> AAGCGCGAATGGCTATGTG
CGAGCCTCCTCGGTGGTTT -> GAGCCTCCTCGGTGGTTTT
CCCATATCTGAGTCTAGCC -> CCATATCTGAGTCTAGCCG
CTGTCGACTAGGAGAATGT -> TGTCGACTAGGAGAATGTG
GAGATGCCAAACATTAGAT -> AGATGCCAAACATTAGATG
CACGTTCCTGACAAGGATA -> ACGTTCCTGACAAGGATAA
GGTCGGTGGATACGAATAG -> GTCGGTGGATACGAATAGT
TAGACCGTTATTTTTCAGG -> AGACCGTTATTTTTCAGGA
AAAGCGTCCGAAACAGCTA -> AAGCGTCCGAAACAGCTAG
CGATGCTGTGACAGCGAGC -> GATGCTGTGACAGCGAGCC
CAAACACAGCTCCAGCTCC -> AAACACAGCTCCAGCTCCC
CCTGGCCGGTCGGGTCGCG -> CTGGCCGGTCGGGTCGCGG
CTACCAAAAGACAAGTTTC -> TACCAAAAGACAAGTTTCA
AGGTTGATCCATCTCGTCC -> GGTTGATCCATCTCGTCCG
AGCTAGTCTTTAACGACTT -> GCTAGTCTTTAACGACTTG
CGACCGTCGCATATCGGGT -> GACCGTCGCATATCGGGTC
TTTCTGGCCGATCAGCACA -> TTCTGGCCGATCAGCACAC
ACAGCAGCGATCCGTAGCA -> CAGCAGCGATCCGTAGCAT
TCTACTCGAACAAACGATC -> CTACTCGAACAAACGATCA
AAAGTACTGAGCTATTTGA -> AAGTACTGAGCTATTTGAT
TACAGCAGCGATCCGTAGC -> ACAGCAGCGATCCGTAGCA
TTAGATAGAGATATGTGGT -> TAGATAGAGATATGTGGTC
CGGATTCATGTCATGCCGG -> GGATTCATGTCATGCCGGT
AGTCAGTACAGGACCTGGG -> GTCAGTACAGGACCTGGGC
TCCAACATTTATAGCTGCT -> CCAACATTTATAGCTGCTA
CACTCTTCTTCATTACAGC -> ACTCTTCTTCATTACAGCA
CGAGGTCACCACGTTCCTG -> GAGGTCACCACGTTCCTGA
CGTACCCCCAGCTCCCGCT -> GTACCCCCAGCTCCCGCTT
GCACAGCTAGTCTTTAACG -> CACAGCTAGTCTTTAACGA
GCCGGTCGGGTCGCGGGGG -> CCGGTCGGGTCGCGGGGGC
GTACGCGCCGCACTAGGAG -> TACGCGCCGCACTAGGAGA
GTCCCGGCCAAACGGGGTC -> TCCCGGCCAAACGGGGTCA
TTGGAGCCTGACATCGCCT -> TGGAGCCTGACATCGCCTA
GGGGGCTACCACGATATCC -> GGGGCTACCACGATATCCG
GCAGCCGGCCGGAAGCGCA -> CAGCCGGCCGGAAGCGCAG
GGACAGTTTGGACTACCAA -> GACAGTTTGGACTACCAAA
GCCCAAAGTCCCCACTTGC -> CCCAAAGTCCCCACTTGCT
GTTCCATAAGAGACGAGGT -> TTCCATAAGAGACGAGGTC
AGCGATCCGTAGCATCCCT -> GCGATCCGTAGCATCCCTA
GGGGGCTACCGCCGCTACT -> GGGGCTACCGCCGCTACTC
CCGTTTGTTGGAGAGTGGT -> CGTTTGTTGGAGAGTGGTA
CCGGCCAAACGGGGTCAGC -> CGGCCAAACGGGGTCAGCA
CGTACGCTTAGATAGAGAT -> GTACGCTTAGATAGAGATA
CCTGAGATGCCAAACATTA -> CTGAGATGCCAAACATTAG
GCAGTCGAAAAGAATAGCC -> CAGTCGAAAAGAATAGCCC
TCATGTCATGCCGGTCCCT -> CATGTCATGCCGGTCCCTT
AGGTACGCGCCGCACTAGG -> GGTACGCGCCGCACTAGGA
TAAAGTACTGAGCTATTTG -> AAAGTACTGAGCTATTTGA
TAACCGTCCGGATTCATGT -> AACCGTCCGGATTCATGTC
GGATTCATGTCATGCCGGT -> GATTCATGTCATGCCGGTC
CAGCTCCAGCTCCCGCTTA -> AGCTCCAGCTCCCGCTTAT
GACGCTTAGCAAGGGTTCC -> ACGCTTAGCAAGGGTTCCA
AATGGAACCAGGCGTCCAT -> ATGGAACCAGGCGTCCATT
CAGGTCGGTGGATACGAAT -> AGGTCGGTGGATACGAATA
GCCTTGCGCTCTACACCGC -> CCTTGCGCTCTACACCGCG
GAGAATGGAACCAGGCGTC -> AGAATGGAACCAGGCGTCC
ATTGTGCTCCGTATTCAAG -> TTGTGCTCCGTATTCAAGT
CCTGGAGCAGCTTCTCGCC -> CTGGAGCAGCTTCTCGCCG
AACAGCTAGCTACGCCCTG -> ACAGCTAGCTACGCCCTGA
AAGACAGCGGGATTCATGC -> AGACAGCGGGATTCATGCA
GAAGTATCGTACCTCCGGA -> AAGTATCGTACCTCCGGAC
AATAGGATATCCCTCATAA -> ATAGGATATCCCTCATAAT
GGCGGCAGTCGAAAAGAAT -> GCGGCAGTCGAAAAGAATA
GCTTGTTTGGCACGCCGCC -> CTTGTTTGGCACGCCGCCA
AGGGGAGAATGGAACCAGG -> GGGGAGAATGGAACCAGGC
TAAGCCCGGCTTTGAACGC -> AAGCCCGGCTTTGAACGCA
GCCGACGACAGGTGCTTGT -> CCGACGACAGGTGCTTGTA
CGATCAGCATAGTAGTTAG -> GATCAGCATAGTAGTTAGA
TAAGGATTACAGCGACCGG -> AAGGATTACAGCGACCGGT
CCATAAGAGACGAGGTCAC -> CATAAGAGACGAGGTCACC
CTTCAAGCACAGCTAGTCT -> TTCAAGCACAGCTAGTCTT
CACAGGTCGGTGGATACGA -> ACAGGTCGGTGGATACGAA
TTAACGACTTGCTGTGGCA -> TAACGACTTGCTGTGGCAT
TTGCGAGACGCCTGGGCGT -> TGCGAGACGCCTGGGCGTT
CCGCCATTATCGGTGGCGA -> CGCCATTATCGGTGGCGAG
CAGCATAGTAGTTAGACGC -> AGCATAGTAGTTAGACGCT
TCACCACGTTCCTGACAAG -> CACCACGTTCCTGACAAGG
GCGTCCGAAACAGCTAGCT -> CGTCCGAAACAGCTAGCTA
ATAGGGATGTGGCAAATTG -> TAGGGATGTGGCAAATTGT
ATTACAGCAGCGATCCGTA -> TTACAGCAGCGATCCGTAG
AGAAGTATCGTACCTCCGG -> GAAGTATCGTACCTCCGGA
GTAATGGCGGTGCGTTGGG -> TAATGGCGGTGCGTTGGGG
GAGCTATTTGATTTACTCT -> AGCTATTTGATTTACTCTC
GAGTTAGGTACGCGCCGCA -> AGTTAGGTACGCGCCGCAC
GACAGCGAGCCTCCTCGGT -> ACAGCGAGCCTCCTCGGTG
AGAGAGACAGAAATCAGGT -> GAGAGACAGAAATCAGGTA
GTATAGGGATGTGGCAAAT -> TATAGGGATGTGGCAAATT
AAGCTAACCGTCCGGATTC -> AGCTAACCGTCCGGATTCA
TAGATGGTTGCCTTAGCAG -> AGATGGTTGCCTTAGCAGC
GCTTCGAGTAGATGGTTGC -> CTTCGAGTAGATGGTTGCC
GACTACCTGGAGCAGCTTC -> ACTACCTGGAGCAGCTTCT
TGGAGAGTGGTAGGTTGAT -> GGAGAGTGGTAGGTTGATC
TCGGGTCGCGGGGGCTACC -> CGGGTCGCGGGGGCTACCG,CGGGTCGCGGGGGCTACCA,CGGGTCGCGGGGGCTACCG,CGGGTCGCGGGGGCTACCC
TCTTGAGCCTTGCGCTCTA -> CTTGAGCCTTGCGCTCTAC
TTTCAGATCAGGATCAGCT -> TTCAGATCAGGATCAGCTA
TGGATACGAATAGTTTCCA -> GGATACGAATAGTTTCCAA
CACGATATCCGGCACTAGG -> ACGATATCCGGCACTAGGC
CAACTCACTCGTTCGAGAT -> AACTCACTCGTTCGAGATA
GGTGGCGAGGGGAGAATGG -> GTGGCGAGGGGAGAATGGA
GAGAGTGGTAGGTTGATCC -> AGAGTGGTAGGTTGATCCA
TCCAAGCTTCGCCAGCTCC -> CCAAGCTTCGCCAGCTCCC
AAGACAAGTTTCACTCTTC -> AGACAAGTTTCACTCTTCT
CATTAGATGAAGTAAATTG -> ATTAGATGAAGTAAATTGA
ACTGAGCTATTTGATTTAC -> CTGAGCTATTTGATTTACT
GTCGCGGGGGCTACCGTTC -> TCGCGGGGGCTACCGTTCG
CTAGTTAGGATAAGAAGGA -> TAGTTAGGATAAGAAGGAC
CGACAGGTGCTTGTACCAT -> GACAGGTGCTTGTACCATA
ATTACCCAAGAATCTACTC -> TTACCCAAGAATCTACTCG
GTTCTGCCCGCTCCTTCTA -> TTCTGCCCGCTCCTTCTAA
TCATGCCGGTCCCTTCAAG -> CATGCCGGTCCCTTCAAGC
CCTGGGCGTTGAGTGGATG -> CTGGGCGTTGAGTGGATGT
TGCTTGTACCATAGTCAGT -> GCTTGTACCATAGTCAGTA
CCACGAGTTAGGTACGCGC -> CACGAGTTAGGTACGCGCC
CTCGTTCGAGATATGCACT -> TCGTTCGAGATATGCACTG
TGACAAGGATAAGCCCGGC -> GACAAGGATAAGCCCGGCT
CATATCGGGTCGCGGGGGC -> ATATCGGGTCGCGGGGGCT
GATAAGAAGGACTTGACGA -> ATAAGAAGGACTTGACGAT
GAGAATGTGAGCTAACGGT -> AGAATGTGAGCTAACGGTA
TAAGAGACGAGGTCACCAC -> AAGAGACGAGGTCACCACG
TTCGAGTAGATGGTTGCCT -> TCGAGTAGATGGTTGCCTT
GATATGTGGTCCCGTGCGT -> ATATGTGGTCCCGTGCGTC
TAGGTTGATCCATCTCGTC -> AGGTTGATCCATCTCGTCC
AAGGATTACAGCGACCGGT -> AGGATTACAGCGACCGGTA
GTTTGGACTACCAAAAGAC -> TTTGGACTACCAAAAGACA
GTCATAAGGTTCGACAGAG -> TCATAAGGTTCGACAGAGA
GTGGCGAGGGGAGAATGGA -> TGGCGAGGGGAGAATGGAA
ATACGATGCTGTGACAGCG -> TACGATGCTGTGACAGCGA
GCCGCTACTCTGTAGGACT -> CCGCTACTCTGTAGGACTA
CGTCGCATATCGGGTCGCG -> GTCGCATATCGGGTCGCGG
GGACTACCTGGAGCAGCTT -> GACTACCTGGAGCAGCTTC
CCGCACTAGGAGAATGCGT -> CGCACTAGGAGAATGCGTT
AGAAGGACTTGACGATCGC -> GAAGGACTTGACGATCGCT
CGTTATGACACAGGTCGGT -> GTTATGACACAGGTCGGTG
GAGCCCTAAGGAGAGTAAG -> AGCCCTAAGGAGAGTAAGG
CAGCTTCTCGCCGGAAGCT -> AGCTTCTCGCCGGAAGCTA
CATAATCCCGGAGCCTGGA -> ATAATCCCGGAGCCTGGAC
TATCCCTCATAATCCCGGA -> ATCCCTCATAATCCCGGAG
CTTGTTTGGCACGCCGCCA -> TTGTTTGGCACGCCGCCAT
GTGCGAGTCCGGTGTGGTG -> TGCGAGTCCGGTGTGGTGC
GGATTACAGCGACCGGTAA -> GATTACAGCGACCGGTAAT
GCGCAGTCGTTGCCCAATA -> CGCAGTCGTTGCCCAATAC
GATGGTTGCCTTAGCAGCC -> ATGGTTGCCTTAGCAGCCG
GGAACCTTGCTTCGTTACT -> GAACCTTGCTTCGTTACTC
TGCGAGACGCCTGGGCGTT -> GCGAGACGCCTGGGCGTTG
AGGCGGCAGTCGAAAAGAA -> GGCGGCAGTCGAAAAGAAT
GAGGTGTACTTCTACGGAA -> AGGTGTACTTCTACGGAAC
ACGAATAGTTTCCAACATT -> CGAATAGTTTCCAACATTT
GCTACCGCCGCTACTCTGT -> CTACCGCCGCTACTCTGTA
GGGAGAATGGAACCAGGCG -> GGAGAATGGAACCAGGCGT
ATGACGGCTTAAGGCTTGT -> TGACGGCTTAAGGCTTGTT
TTACCGTTCACACCTGAGA -> TACCGTTCACACCTGAGAT
ATAAGCCCGGCTTTGAACG -> TAAGCCCGGCTTTGAACGC
TTTACCGTTCACACCTGAG -> TTACCGTTCACACCTGAGA
ACACAAGTTGCGGTGAGGA -> CACAAGTTGCGGTGAGGAA
GGGATGTGGCAAATTGTGC -> GGATGTGGCAAATTGTGCT
ATACCTGGGGAGTGACAAA -> TACCTGGGGAGTGACAAAC
TTATACGGTCCTGGCCGGT -> TATACGGTCCTGGCCGGTC
AGTTTCACTCTTCTTCATT -> GTTTCACTCTTCTTCATTA
TCCTTCTAAGTTTCTGGCC -> CCTTCTAAGTTTCTGGCCG
CCGCTTATACGTACCGGCT -> CGCTTATACGTACCGGCTC
AACCCGATTGTTTACCGTT -> ACCCGATTGTTTACCGTTC
AACACAGCTCCAGCTCCCG -> ACACAGCTCCAGCTCCCGC
TGGTCCCGTGCGTCCTTTC -> GGTCCCGTGCGTCCTTTCA
GTCCTTTCAGATCAGGATC -> TCCTTTCAGATCAGGATCA
TAAGGCAGTCATAAGGTTC -> AAGGCAGTCATAAGGTTCG
TTGAACGCAATGAGATCCT -> TGAACGCAATGAGATCCTA
GTGCCCATATCTGAGTCTA -> TGCCCATATCTGAGTCTAG
CCGTCCGGATTCATGTCAT -> CGTCCGGATTCATGTCATG
TGGGACCTGTAGGATGTCC -> GGGACCTGTAGGATGTCCC
GCGGGATTCATGCAAGTCC -> CGGGATTCATGCAAGTCCC
GCATATCGGGTCGCGGGGG -> CATATCGGGTCGCGGGGGC
TTCATGCAAGTCCCTAGTT -> TCATGCAAGTCCCTAGTTA
CGCGAATGGCTATGTGATT -> GCGAATGGCTATGTGATTA
TCTTCTTCATTACAGCAGC -> CTTCTTCATTACAGCAGCG
ATGTAAGACGTGTGGGACC -> TGTAAGACGTGTGGGACCT
GACGATCGCTAAGGCAGTC -> ACGATCGCTAAGGCAGTCA
AGCGCGAATGGCTATGTGA -> GCGCGAATGGCTATGTGAT
GTCCCGTGCGTCCTTTCAG -> TCCCGTGCGTCCTTTCAGA
CTTCATTACAGCAGCGATC -> TTCATTACAGCAGCGATCC
GGAGCCTGGACAGTTTGGA -> GAGCCTGGACAGTTTGGAC
TGCTGTGGCATTTGTAGAC -> GCTGTGGCATTTGTAGACC
GTGTAACGTCTGATCTCCA -> TGTAACGTCTGATCTCCAT
TTCAGATCAGGATCAGCTA -> TCAGATCAGGATCAGCTAC
TTCCAATAGGATATCCCTC -> TCCAATAGGATATCCCTCA
CTCCCGCTTATACGTACCG -> TCCCGCTTATACGTACCGG
GGGGCTGAGGCTAAGCGCG -> GGGCTGAGGCTAAGCGCGA
TTCACTTAAAACTCGCAAC -> TCACTTAAAACTCGCAACT
GGACTTGACGATCGCTAAG -> GACTTGACGATCGCTAAGG
TTCGCTCCCTGCTGAAGTA -> TCGCTCCCTGCTGAAGTAC
ACACCGTCAGCCCGGCTGG -> CACCGTCAGCCCGGCTGGA
ACCTTGCTTCGTTACTCGT -> CCTTGCTTCGTTACTCGTT
GCGGGGGCTACCACGATAT -> CGGGGGCTACCACGATATC
CTCAAAGCGTCCGAAACAG -> TCAAAGCGTCCGAAACAGC
AAACCAAGCTCTATTTGCC -> AACCAAGCTCTATTTGCCT
TGTCCAAGCTTCGCCAGCT -> GTCCAAGCTTCGCCAGCTC
CCGTATTCAAGTGTGTCCG -> CGTATTCAAGTGTGTCCGA
CCGCTTATACGGTCCTGGC -> CGCTTATACGGTCCTGGCC
TCCGAAACAGCTAGCTACG -> CCGAAACAGCTAGCTACGC
CGGAACCTTGCTTCGTTAC -> GGAACCTTGCTTCGTTACT
TTTGCCGACGACAGGTGCT -> TTGCCGACGACAGGTGCTT
AAACGATCAGCATAGTAGT -> AACGATCAGCATAGTAGTT
GCAAGTCCCTAGTTAGGAT -> CAAGTCCCTAGTTAGGATA
ACCAGGCGTCCATTGCCAC -> CCAGGCGTCCATTGCCACG
ATCCCTCATAATCCCGGAG -> TCCCTCATAATCCCGGAGC
CTCTCTTTGCCGACGACAG -> TCTCTTTGCCGACGACAGG
AAGTAAATTGAGAGTCTGC -> AGTAAATTGAGAGTCTGCT
GGTCACCACGTTCCTGACA -> GTCACCACGTTCCTGACAA
TAAATACCTGGGGAGTGAC -> AAATACCTGGGGAGTGACA
CGTTTCGCGCAGAGCAAGT -> GTTTCGCGCAGAGCAAGTG
GACCGAGCAGAATGACGGC -> ACCGAGCAGAATGACGGCT
TTTAACTCACGAGTTTCAA -> TTAACTCACGAGTTTCAAG
CCCCCAGCTCCCGCTTATA -> CCCCAGCTCCCGCTTATAC
GCTTTGGAGCCTGACATCG -> CTTTGGAGCCTGACATCGC
GTTCGGTGTATAGGGATGT -> TTCGGTGTATAGGGATGTG
TCGTGAAACCAAGCTCTAT -> CGTGAAACCAAGCTCTATT
CTTTCATTTTCCGTCCCGG -> TTTCATTTTCCGTCCCGGC
AAAGTCCCCACTTGCTTCG -> AAGTCCCCACTTGCTTCGA
ATCTACTCGAACAAACGAT -> TCTACTCGAACAAACGATC
TAGTCAGTACAGGACCTGG -> AGTCAGTACAGGACCTGGG
TTAAGGCTTGTTTGGCACG -> TAAGGCTTGTTTGGCACGC
ATCGGGTCGCGGGGGCTAC -> TCGGGTCGCGGGGGCTACC
CCTATACGTCATCCGTTTG -> CTATACGTCATCCGTTTGT
AGCAGCCGGCCGGAAGCGC -> GCAGCCGGCCGGAAGCGCA
TGTCGACTAGGAGAATGTG -> GTCGACTAGGAGAATGTGA
CTCCTCGGTGGTTTTGGGA -> TCCTCGGTGGTTTTGGGAG
GGATAAGCCCGGCTTTGAA -> GATAAGCCCGGCTTTGAAC
TTGGCACGCCGCCATTATC -> TGGCACGCCGCCATTATCG
TTGTAGACCGTTATTTTTC -> TGTAGACCGTTATTTTTCA
CATGTCATGCCGGTCCCTT -> ATGTCATGCCGGTCCCTTC
GCCAAACGGGGTCAGCAGG -> CCAAACGGGGTCAGCAGGC
AGCCGTTCAAAACGGTTCC -> GCCGTTCAAAACGGTTCCA
TCATTACAGCAGCGATCCG -> CATTACAGCAGCGATCCGT
CATAAGGTTCGACAGAGAG -> ATAAGGTTCGACAGAGAGA
GGTCCTGGCCGGTCGGGTC -> GTCCTGGCCGGTCGGGTCG
CCACGATATCCGGCACTAG -> CACGATATCCGGCACTAGG
CTTAAGCCCGTACCCCCAG -> TTAAGCCCGTACCCCCAGC
CAAGTTTCACTCTTCTTCA -> AAGTTTCACTCTTCTTCAT
CGTTCACACCTGAGATGCC -> GTTCACACCTGAGATGCCA
CCCGTACCCCCAGCTCCCG -> CCGTACCCCCAGCTCCCGC
CATAAGAGACGAGGTCACC -> ATAAGAGACGAGGTCACCA
AATAGTTTCCAACATTTAT -> ATAGTTTCCAACATTTATA
CTAGCTACGCCCTGAGCGT -> TAGCTACGCCCTGAGCGTT
CGCTTAGCAAGGGTTCCAA -> GCTTAGCAAGGGTTCCAAT
TGTGGTCCCGTGCGTCCTT -> GTGGTCCCGTGCGTCCTTT
CTCTTTCGGGTCGCGGGGG -> TCTTTCGGGTCGCGGGGGC
ATAGAGATATGTGGTCCCG -> TAGAGATATGTGGTCCCGT
GTAGGATGTCCCTTGCGAG -> TAGGATGTCCCTTGCGAGA
TTCATTTTCCGTCCCGGCC -> TCATTTTCCGTCCCGGCCA
TTATACGCTTGTTATCAGT -> TATACGCTTGTTATCAGTC
CCTTGCGCTCTACACCGCG -> CTTGCGCTCTACACCGCGT
TGGGGAGTGACAAACACAG -> GGGGAGTGACAAACACAGC
GGCGAGGGGAGAATGGAAC -> GCGAGGGGAGAATGGAACC
TCTGCCCGCTCCTTCTAAG -> CTGCCCGCTCCTTCTAAGT
CACGCCGCCATTATCGGTG -> ACGCCGCCATTATCGGTGG
GGGCTACCGTTCGGTGTAT -> GGCTACCGTTCGGTGTATA
GAGTCCGGTGTGGTGCCTG -> AGTCCGGTGTGGTGCCTGG
TTAGGATAAGAAGGACTTG -> TAGGATAAGAAGGACTTGA
CCCCAGCTCCCGCTTATAC -> CCCAGCTCCCGCTTATACG
CGCGGGGGCTACCGTTCGG -> GCGGGGGCTACCGTTCGGT
TCAACTCACTCGTTCGAGA -> CAACTCACTCGTTCGAGAT
CAGCTAGCTACGCCCTGAG -> AGCTAGCTACGCCCTGAGC
TGGGTGCCCATATCTGAGT -> GGGTGCCCATATCTGAGTC
CACTTCACTTAAAACTCGC -> ACTTCACTTAAAACTCGCA
CTAAGGAGAGTAAGGATTA -> TAAGGAGAGTAAGGATTAC
GTTTTGGGAGCGGTGACGA -> TTTTGGGAGCGGTGACGAT
AGCTCCCGCTTATACGTAC -> GCTCCCGCTTATACGTACC
GGCCGGAAGCGCAGTCGTT -> GCCGGAAGCGCAGTCGTTG
GACCGTCGCATATCGGGTC -> ACCGTCGCATATCGGGTCG
ACTTTCATGGAATCACACA -> CTTTCATGGAATCACACAC
TATCAGTCGGGTCGCGGGG -> ATCAGTCGGGTCGCGGGGG
TGGCACGCCGCCATTATCG -> GGCACGCCGCCATTATCGG
GATACCCTACTTTCATGGA -> ATACCCTACTTTCATGGAA
CACTAGGCGTCAACTCACT -> ACTAGGCGTCAACTCACTC
AACATTAGATGAAGTAAAT -> ACATTAGATGAAGTAAATT
GAGACAGAAATCAGGTAAC -> AGACAGAAATCAGGTAACC
GTGGTTTTGGGAGCGGTGA -> TGGTTTTGGGAGCGGTGAC
GACAACGAAGGGACCGAGC -> ACAACGAAGGGACCGAGCA
CTTTAACTCACGAGTTTCA -> TTTAACTCACGAGTTTCAA
TAAGAAGGACTTGACGATC -> AAGAAGGACTTGACGATCG
TTTCATTTTCCGTCCCGGC -> TTCATTTTCCGTCCCGGCC
CGAAACAGCTAGCTACGCC -> GAAACAGCTAGCTACGCCC
GTGAGTCTCAATAAAGTAC -> TGAGTCTCAATAAAGTACT
ATGGCTATGTGATTACCCA -> TGGCTATGTGATTACCCAA
TTCGAGATATGCACTGGGC -> TCGAGATATGCACTGGGCG
GACAGAGAGAGACAGAAAT -> ACAGAGAGAGACAGAAATC
CGGTCCCTTCAAGCACAGC -> GGTCCCTTCAAGCACAGCT
CTCCCGCTTATACGGTCCT -> TCCCGCTTATACGGTCCTG
CATTTATAGCTGCTAAGAA -> ATTTATAGCTGCTAAGAAG
TCCTGACAAGGATAAGCCC -> CCTGACAAGGATAAGCCCG
GGGCTACCACGATATCCGG -> GGCTACCACGATATCCGGC
AAACATTAGATGAAGTAAA -> AACATTAGATGAAGTAAAT
CTCGTTCTGCCCGCTCCTT -> TCGTTCTGCCCGCTCCTTC
GCCCTGAGCGTTTCGCGCA -> CCCTGAGCGTTTCGCGCAG
TCGCATATCGGGTCGCGGG -> CGCATATCGGGTCGCGGGG
CTCATAATCCCGGAGCCTG -> TCATAATCCCGGAGCCTGG
ATGTCCAAGCTTCGCCAGC -> TGTCCAAGCTTCGCCAGCT
GCGGGGGCTACCGCCGCTA -> CGGGGGCTACCGCCGCTAC
ACGCTTAGCAAGGGTTCCA -> CGCTTAGCAAGGGTTCCAA
AGGTTCGACAGAGAGAGAC -> GGTTCGACAGAGAGAGACA
GGGACCTGTAGGATGTCCC -> GGACCTGTAGGATGTCCCT
ACCGTTCGGTGTATAGGGA -> CCGTTCGGTGTATAGGGAT
CCTTTCAGATCAGGATCAG -> CTTTCAGATCAGGATCAGC
GCGAGGGGAGAATGGAACC -> CGAGGGGAGAATGGAACCA
CTGTGGCATTTGTAGACCG -> TGTGGCATTTGTAGACCGT
TCGACTAGGAGAATGTGAG -> CGACTAGGAGAATGTGAGC
ACCGCCGCTACTCTGTAGG -> CCGCCGCTACTCTGTAGGA
GGAAGCGCAGTCGTTGCCC -> GAAGCGCAGTCGTTGCCCA
TGCGTCCTTTCAGATCAGG -> GCGTCCTTTCAGATCAGGA
GTAAGACGTGTGGGACCTG -> TAAGACGTGTGGGACCTGT
CGGCACTAGGCGTCAACTC -> GGCACTAGGCGTCAACTCA
GACACAGGTCGGTGGATAC -> ACACAGGTCGGTGGATACG
TAGTTTCCAACATTTATAG -> AGTTTCCAACATTTATAGC
TGTTTACCGTTCACACCTG -> GTTTACCGTTCACACCTGA
TCACTTCACTTAAAACTCG -> CACTTCACTTAAAACTCGC
ACTGATCTTCGCTCCCTGC -> CTGATCTTCGCTCCCTGCT
CCTAGTTAGGATAAGAAGG -> CTAGTTAGGATAAGAAGGA
AATCTACTCGAACAAACGA -> ATCTACTCGAACAAACGAT
CGCCGCTACTCTGTAGGAC -> GCCGCTACTCTGTAGGACT
CAAGCACAGCTAGTCTTTA -> AAGCACAGCTAGTCTTTAA
CCTCCTCGGTGGTTTTGGG -> CTCCTCGGTGGTTTTGGGA
CGGTCCTGGCCGGTCGGGT -> GGTCCTGGCCGGTCGGGTC
CGCTCCCTGCTGAAGTACT -> GCTCCCTGCTGAAGTACTG
TCGCCAGCTCCCGCTTATA -> CGCCAGCTCCCGCTTATAC
ACCGTCAGCCCGGCTGGAG -> CCGTCAGCCCGGCTGGAGG
TATCGTACCTCCGGACTAA -> ATCGTACCTCCGGACTAAC
TTTCCGTCCCGGCCAAACG -> TTCCGTCCCGGCCAAACGG
ACTTCACTTAAAACTCGCA -> CTTCACTTAAAACTCGCAA
GTCGCATATCGGGTCGCGG -> TCGCATATCGGGTCGCGGG
TCTGATCTCCATCACTTCA -> CTGATCTCCATCACTTCAC
TAGGATGTCCCTTGCGAGA -> AGGATGTCCCTTGCGAGAC
ACTCTTGAGCCTTGCGCTC -> CTCTTGAGCCTTGCGCTCT
ACACTCCTTTAACTCACGA -> CACTCCTTTAACTCACGAG
AGCACACCGTCAGCCCGGC -> GCACACCGTCAGCCCGGCT
GTGAGCTAACGGTACATGG -> TGAGCTAACGGTACATGGG
CACAGCTCCAGCTCCCGCT -> ACAGCTCCAGCTCCCGCTT
GAGTGGATGTCCAAGCTTC -> AGTGGATGTCCAAGCTTCG
CGCTTATACGGTCCTGGCC -> GCTTATACGGTCCTGGCCG
GGCACGCCGCCATTATCGG -> GCACGCCGCCATTATCGGT
AGTCGAAAAGAATAGCCCA -> GTCGAAAAGAATAGCCCAA
GCTAACGGTACATGGGTGC -> CTAACGGTACATGGGTGCG
GGTCGCGGGGGCTACCCAT -> GTCGCGGGGGCTACCCATG
ACAGCTAGCTACGCCCTGA -> CAGCTAGCTACGCCCTGAG
TTCCGTCCCGGCCAAACGG -> TCCGTCCCGGCCAAACGGG
GTCTAGCCGTACGCTTAGA -> TCTAGCCGTACGCTTAGAT
CCACTTGCTTCGAGTAGAT -> CACTTGCTTCGAGTAGATG
GTCCGAAACAGCTAGCTAC -> TCCGAAACAGCTAGCTACG
TGTGGCATTTGTAGACCGT -> GTGGCATTTGTAGACCGTT
GCGTAGACGATCGAACACT -> CGTAGACGATCGAACACTC
GGGAGCGGTGACGATCGCT -> GGAGCGGTGACGATCGCTC
GTCGTGAAACCAAGCTCTA -> TCGTGAAACCAAGCTCTAT
AGACGCCTGGGCGTTGAGT -> GACGCCTGGGCGTTGAGTG
CGAATGGCTATGTGATTAC -> GAATGGCTATGTGATTACC
CCGGCTGGAGGATAACCCA -> CGGCTGGAGGATAACCCAC
TAGGCGTCAACTCACTCGT -> AGGCGTCAACTCACTCGTT
GCTAACCGTCCGGATTCAT -> CTAACCGTCCGGATTCATG
CTTATACGACCGTCGCATA -> TTATACGACCGTCGCATAT
TGTGATTACCCAAGAATCT -> GTGATTACCCAAGAATCTA
GACAAGGATAAGCCCGGCT -> ACAAGGATAAGCCCGGCTT
TTAGCAAGGGTTCCAATAG -> TAGCAAGGGTTCCAATAGG
CCAACACAAGTTGCGGTGA -> CAACACAAGTTGCGGTGAG
AAAACGGTTCCATAAGAGA -> AAACGGTTCCATAAGAGAC
TGGTGCCTGGTCGTGAAAC -> GGTGCCTGGTCGTGAAACC
TATTTGATTTACTCTCTTT -> ATTTGATTTACTCTCTTTG
GATCTTCGCTCCCTGCTGA -> ATCTTCGCTCCCTGCTGAA
AGATGAAGTAAATTGAGAG -> GATGAAGTAAATTGAGAGT
CGCTTATACGCTTGTTATC -> GCTTATACGCTTGTTATCA
ACTTGCTTCGAGTAGATGG -> CTTGCTTCGAGTAGATGGT
CGTGTGGGACCTGTAGGAT -> GTGTGGGACCTGTAGGATG
GGTGCGTTGGGGCTGAGGC -> GTGCGTTGGGGCTGAGGCT
AGCTTCTCGCCGGAAGCTA -> GCTTCTCGCCGGAAGCTAA
AGACGAGGTCACCACGTTC -> GACGAGGTCACCACGTTCC
TCAGCCCGGCTGGAGGATA -> CAGCCCGGCTGGAGGATAA
AGGATAAGCCCGGCTTTGA -> GGATAAGCCCGGCTTTGAA
GCTTAGCAAGGGTTCCAAT -> CTTAGCAAGGGTTCCAATA
ACTAACGAGGTGTACTTCT -> CTAACGAGGTGTACTTCTA
GTAGCATCCCTACTCGCCA -> TAGCATCCCTACTCGCCAA
TCTTTGCCGACGACAGGTG -> CTTTGCCGACGACAGGTGC
CACCGTCAGCCCGGCTGGA -> ACCGTCAGCCCGGCTGGAG
GATGTCCCTTGCGAGACGC -> ATGTCCCTTGCGAGACGCC
CACAAGTTGCGGTGAGGAA -> ACAAGTTGCGGTGAGGAAG
AGACGTGTGGGACCTGTAG -> GACGTGTGGGACCTGTAGG
AAGTTGCGGTGAGGAAGGC -> AGTTGCGGTGAGGAAGGCT
TAGAGATATGTGGTCCCGT -> AGAGATATGTGGTCCCGTG
CTTGACGATCGCTAAGGCA -> TTGACGATCGCTAAGGCAG
CTAGCCGTACGCTTAGATA -> TAGCCGTACGCTTAGATAG
ATTCAAGTGTGTCCGAGCC -> TTCAAGTGTGTCCGAGCCA
AAGCTATCTCCGACAAGAC -> AGCTATCTCCGACAAGACA
TCTCCGACAAGACAGCGGG -> CTCCGACAAGACAGCGGGA
GGTCCCGTGCGTCCTTTCA -> GTCCCGTGCGTCCTTTCAG
GTTCCTGACAAGGATAAGC -> TTCCTGACAAGGATAAGCC
CGACGACAGGTGCTTGTAC -> GACGACAGGTGCTTGTACC
TCAAGTGTGTCCGAGCCAC -> CAAGTGTGTCCGAGCCACT
CGAATAGTTTCCAACATTT -> GAATAGTTTCCAACATTTA
TATACGACCGTCGCATATC -> ATACGACCGTCGCATATCG
CCGAAACAGCTAGCTACGC -> CGAAACAGCTAGCTACGCC
CGTTCGGTGTATAGGGATG -> GTTCGGTGTATAGGGATGT
GCTCCTTCTAAGTTTCTGG -> CTCCTTCTAAGTTTCTGGC
AGGAGCTGTCGACTAGGAG -> GGAGCTGTCGACTAGGAGA
GAGTTTCAAGTTTCGACTT -> AGTTTCAAGTTTCGACTTA
TTCGTTACTCGTTCTGCCC -> TCGTTACTCGTTCTGCCCG
CAAGCTATCTCCGACAAGA -> AAGCTATCTCCGACAAGAC
AGCTCCCGCTTATACGACC -> GCTCCCGCTTATACGACCG
GGCCAAACGGGGTCAGCAG -> GCCAAACGGGGTCAGCAGG
ACGAGTTTCAAGTTTCGAC -> CGAGTTTCAAGTTTCGACT
AGCTAACCGTCCGGATTCA -> GCTAACCGTCCGGATTCAT
GCTGAGGCTAAGCGCGAAT -> CTGAGGCTAAGCGCGAATG
GGCACTAGGCGTCAACTCA -> GCACTAGGCGTCAACTCAC
GCCCTAAGGAGAGTAAGGA -> CCCTAAGGAGAGTAAGGAT
TTTGAACGCAATGAGATCC -> TTGAACGCAATGAGATCCT
CAAGTTTCGACTTAAGCCC -> AAGTTTCGACTTAAGCCCG
AAGTACTGTTCTCGTTATG -> AGTACTGTTCTCGTTATGA
CTATACGTCATCCGTTTGT -> TATACGTCATCCGTTTGTT
CTACTCTGTAGGACTACCT -> TACTCTGTAGGACTACCTG
TTACTCTCTTTGCCGACGA -> TACTCTCTTTGCCGACGAC
AGCGGTGACGATCGCTCAA -> GCGGTGACGATCGCTCAAA
CCAAACGGGGTCAGCAGGC -> CAAACGGGGTCAGCAGGCG
GAGCCTGGACAGTTTGGAC -> AGCCTGGACAGTTTGGACT
CTGATCTTCGCTCCCTGCT -> TGATCTTCGCTCCCTGCTG
AAGGAGAGTAAGGATTACA -> AGGAGAGTAAGGATTACAG
GTGTGTCCGAGCCACTCAT -> TGTGTCCGAGCCACTCATA
ACACCTGAGATGCCAAACA -> CACCTGAGATGCCAAACAT
AGTGTGTCCGAGCCACTCA -> GTGTGTCCGAGCCACTCAT
CGTTCGAGATATGCACTGG -> GTTCGAGATATGCACTGGG
TTGTGCTCCGTATTCAAGT -> TGTGCTCCGTATTCAAGTG
GAATAGTTTCCAACATTTA -> AATAGTTTCCAACATTTAT
GGCTAAGCGCGAATGGCTA -> GCTAAGCGCGAATGGCTAT
CAGTCGAAAAGAATAGCCC -> AGTCGAAAAGAATAGCCCA
GACCGTTATTTTTCAGGAT -> ACCGTTATTTTTCAGGATA
TCGTTGCCCAATACGATGC -> CGTTGCCCAATACGATGCT
CGGGGGCTACCGCCGCTAC -> GGGGGCTACCGCCGCTACT
TATCGGGTCGCGGGGGCTA -> ATCGGGTCGCGGGGGCTAC
CTTTAACGACTTGCTGTGG -> TTTAACGACTTGCTGTGGC
CGAGTTAGGTACGCGCCGC -> GAGTTAGGTACGCGCCGCA
CTAAGCGCGAATGGCTATG -> TAAGCGCGAATGGCTATGT
CCCACTGAAGAACTGATCT -> CCACTGAAGAACTGATCTT
TTGCTTCGAGTAGATGGTT -> TGCTTCGAGTAGATGGTTG
GCTATGTGATTACCCAAGA -> CTATGTGATTACCCAAGAA
CCGGACTAACTAACGAGGT -> CGGACTAACTAACGAGGTG
GGATATCCCTCATAATCCC -> GATATCCCTCATAATCCCG
GGTAACCCGATTGTTTACC -> GTAACCCGATTGTTTACCG
TCTCCATCACTTCACTTAA -> CTCCATCACTTCACTTAAA
TCCGAGCCACTCATAGCGG -> CCGAGCCACTCATAGCGGG
CGTACCGGCTCTTTCGGGT -> GTACCGGCTCTTTCGGGTC
TTTCGGGTCGCGGGGGCTA -> TTCGGGTCGCGGGGGCTAC
TTTTTCAGGATACCCTACT -> TTTTCAGGATACCCTACTT
CAGGTGCTTGTACCATAGT -> AGGTGCTTGTACCATAGTC
GTGAAACCAAGCTCTATTT -> TGAAACCAAGCTCTATTTG
TTATCAGTCGGGTCGCGGG -> TATCAGTCGGGTCGCGGGG
AATGGCTATGTGATTACCC -> ATGGCTATGTGATTACCCA
AGAGTAAGGATTACAGCGA -> GAGTAAGGATTACAGCGAC
GTCCGGATTCATGTCATGC -> TCCGGATTCATGTCATGCC
GAGCGGTGACGATCGCTCA -> AGCGGTGACGATCGCTCAA
GCCACGAGTTAGGTACGCG -> CCACGAGTTAGGTACGCGC
GCCGTACGCTTAGATAGAG -> CCGTACGCTTAGATAGAGA
TTGTTTGGCACGCCGCCAT -> TGTTTGGCACGCCGCCATT
TCCCGCTTATACGCTTGTT -> CCCGCTTATACGCTTGTTA
CATAGTAGTTAGACGCTTA -> ATAGTAGTTAGACGCTTAG
CTACCGCCGCTACTCTGTA -> TACCGCCGCTACTCTGTAG
AGTTGCGGTGAGGAAGGCT -> GTTGCGGTGAGGAAGGCTT
AAGAGACGAGGTCACCACG -> AGAGACGAGGTCACCACGT
GGTACGCGCCGCACTAGGA -> GTACGCGCCGCACTAGGAG
TAGGATAAGAAGGACTTGA -> AGGATAAGAAGGACTTGAC
TTCCATAAGAGACGAGGTC -> TCCATAAGAGACGAGGTCA
CCGCTTATACGCTTGTTAT -> CGCTTATACGCTTGTTATC
CTAACCGTCCGGATTCATG -> TAACCGTCCGGATTCATGT
TATCTCCGACAAGACAGCG -> ATCTCCGACAAGACAGCGG
TGGTTTTGGGAGCGGTGAC -> GGTTTTGGGAGCGGTGACG
GTCCGGAACCTTGCTTCGT -> TCCGGAACCTTGCTTCGTT
TTAGGTACGCGCCGCACTA -> TAGGTACGCGCCGCACTAG
ACAGCTCCAGCTCCCGCTT -> CAGCTCCAGCTCCCGCTTA
ACCGCAGCCGTTCAAAACG -> CCGCAGCCGTTCAAAACGG
GCCTGGTCGTGAAACCAAG -> CCTGGTCGTGAAACCAAGC
CAGCACACCGTCAGCCCGG -> AGCACACCGTCAGCCCGGC
CGTAGACGATCGAACACTC -> GTAGACGATCGAACACTCC
CGTCCGGAACCTTGCTTCG -> GTCCGGAACCTTGCTTCGT
GATCCGTAGCATCCCTACT -> ATCCGTAGCATCCCTACTC
TGAGATCCTATACGTCATC -> GAGATCCTATACGTCATCC
AACGAAGGGACCGAGCAGA -> ACGAAGGGACCGAGCAGAA
AGACAAGTTTCACTCTTCT -> GACAAGTTTCACTCTTCTT
TCGAACACTCCTTTAACTC -> CGAACACTCCTTTAACTCA
GGTGAGGAAGGCTTTATGA -> GTGAGGAAGGCTTTATGAC
AAGCGTCCGAAACAGCTAG -> AGCGTCCGAAACAGCTAGC
CGCTCAAAGCGTCCGAAAC -> GCTCAAAGCGTCCGAAACA
CGTCCGAAACAGCTAGCTA -> GTCCGAAACAGCTAGCTAC
ATAAGAGACGAGGTCACCA -> TAAGAGACGAGGTCACCAC
CGCACTAGGAGAATGCGTT -> GCACTAGGAGAATGCGTTA
CGCCGCCATTATCGGTGGC -> GCCGCCATTATCGGTGGCG
ATACGTCATCCGTTTGTTG -> TACGTCATCCGTTTGTTGG
AATTGAGAGTCTGCTCAGA -> ATTGAGAGTCTGCTCAGAG
TATTTTTCAGGATACCCTA -> ATTTTTCAGGATACCCTAC
AAGTCCCCACTTGCTTCGA -> AGTCCCCACTTGCTTCGAG
CACCGCGTAGACGATCGAA -> ACCGCGTAGACGATCGAAC
TTATCGGTGGCGAGGGGAG -> TATCGGTGGCGAGGGGAGA
CGCCTGGGCGTTGAGTGGA -> GCCTGGGCGTTGAGTGGAT
CTCTATTTGCCTTTCATTT -> TCTATTTGCCTTTCATTTT
GATCCATCTCGTCCGGAAC -> ATCCATCTCGTCCGGAACC
AGCAGAATGACGGCTTAAG -> GCAGAATGACGGCTTAAGG
CTGGGGAGTGACAAACACA -> TGGGGAGTGACAAACACAG
GAATCTACTCGAACAAACG -> AATCTACTCGAACAAACGA
AGGATAACCCACTGAAGAA -> GGATAACCCACTGAAGAAC
GGAGGATAACCCACTGAAG -> GAGGATAACCCACTGAAGA
CCGAGCAGAATGACGGCTT -> CGAGCAGAATGACGGCTTA
CTGCTCAGAGCCCTAAGGA -> TGCTCAGAGCCCTAAGGAG
ACCCATGTAAGACGTGTGG -> CCCATGTAAGACGTGTGGG
ATCAGCTACTCTTGAGCCT -> TCAGCTACTCTTGAGCCTT
TTTCGACTTAAGCCCGTAC -> TTCGACTTAAGCCCGTACC
TGAGCTAACGGTACATGGG -> GAGCTAACGGTACATGGGT
CAGCCGGCCGGAAGCGCAG -> AGCCGGCCGGAAGCGCAGT
TCGAAAAGAATAGCCCAAA -> CGAAAAGAATAGCCCAAAG
CAAAGCGTCCGAAACAGCT -> AAAGCGTCCGAAACAGCTA
CCACTCATAGCGGGCCATT -> CACTCATAGCGGGCCATTC
GTTAGGATAAGAAGGACTT -> TTAGGATAAGAAGGACTTG
GCTCTACACCGCGTAGACG -> CTCTACACCGCGTAGACGA
ACAGGTGCTTGTACCATAG -> CAGGTGCTTGTACCATAGT
TTTCACTCTTCTTCATTAC -> TTCACTCTTCTTCATTACA
GAGAGTCTGCTCAGAGCCC -> AGAGTCTGCTCAGAGCCCT
TTTGCACCGCAGCCGTTCA -> TTGCACCGCAGCCGTTCAA
CATGCCGGTCCCTTCAAGC -> ATGCCGGTCCCTTCAAGCA
CTGAGCTATTTGATTTACT -> TGAGCTATTTGATTTACTC
CAGGATCAGCTACTCTTGA -> AGGATCAGCTACTCTTGAG
TTTGGCACGCCGCCATTAT -> TTGGCACGCCGCCATTATC
TACCGTTCGGTGTATAGGG -> ACCGTTCGGTGTATAGGGA
CGGTGACGATCGCTCAAAG -> GGTGACGATCGCTCAAAGC
TTTGGACTACCAAAAGACA -> TTGGACTACCAAAAGACAA
TACTCTTGAGCCTTGCGCT -> ACTCTTGAGCCTTGCGCTC
AGCCTGGACAGTTTGGACT -> GCCTGGACAGTTTGGACTA
TACCAAAAGACAAGTTTCA -> ACCAAAAGACAAGTTTCAC
GAGCCTGACATCGCCTATA -> AGCCTGACATCGCCTATAA
CATGGAATCACACACAAGG -> ATGGAATCACACACAAGGA
GCCATTCAGCCTGGGTGCC -> CCATTCAGCCTGGGTGCCC
ACTCGTTCTGCCCGCTCCT -> CTCGTTCTGCCCGCTCCTT
CTAAATACCTGGGGAGTGA -> TAAATACCTGGGGAGTGAC
GCAGAGCAAGTGAGTCTCA -> CAGAGCAAGTGAGTCTCAA
TCTCGTCCGGAACCTTGCT -> CTCGTCCGGAACCTTGCTT
CAATGAGATCCTATACGTC -> AATGAGATCCTATACGTCA
AGGTCGGTGGATACGAATA -> GGTCGGTGGATACGAATAG
CCATATCTGAGTCTAGCCG -> CATATCTGAGTCTAGCCGT
CGAGTAGATGGTTGCCTTA -> GAGTAGATGGTTGCCTTAG
CGGAACCAGCTCCCGCTTA -> GGAACCAGCTCCCGCTTAT
GTGGGACCTGTAGGATGTC -> TGGGACCTGTAGGATGTCC
AGTCATAAGGTTCGACAGA -> GTCATAAGGTTCGACAGAG
CCGTAGCATCCCTACTCGC -> CGTAGCATCCCTACTCGCC
AGCCTGACATCGCCTATAA -> GCCTGACATCGCCTATAAT
AAATTGAGAGTCTGCTCAG -> AATTGAGAGTCTGCTCAGA
GAACCAGGCGTCCATTGCC -> AACCAGGCGTCCATTGCCA
GCTGTGACAGCGAGCCTCC -> CTGTGACAGCGAGCCTCCT
GCTCTTTCGGGTCGCGGGG -> CTCTTTCGGGTCGCGGGGG
CCGGTGTGGTGCCTGGTCG -> CGGTGTGGTGCCTGGTCGT
CCGATCAGCACACCGTCAG -> CGATCAGCACACCGTCAGC
AGCTAACGGTACATGGGTG -> GCTAACGGTACATGGGTGC
CGCAATGAGATCCTATACG -> GCAATGAGATCCTATACGT
GACGACAGGTGCTTGTACC -> ACGACAGGTGCTTGTACCA
GCCGTTCAAAACGGTTCCA -> CCGTTCAAAACGGTTCCAT
TAGGGATGTGGCAAATTGT -> AGGGATGTGGCAAATTGTG
GCCAGCTCCCGCTTATACG -> CCAGCTCCCGCTTATACGG
GCACTGGGCGTGTAACGTC -> CACTGGGCGTGTAACGTCT
GCTCCCGCTTATACGCTTG -> CTCCCGCTTATACGCTTGT
CTCGCAACTAAATACCTGG -> TCGCAACTAAATACCTGGG
CCTGAGCGTTTCGCGCAGA -> CTGAGCGTTTCGCGCAGAG
GCAGTCGTTGCCCAATACG -> CAGTCGTTGCCCAATACGA
TAGTAGTTAGACGCTTAGC -> AGTAGTTAGACGCTTAGCA
ATCGCTAAGGCAGTCATAA -> TCGCTAAGGCAGTCATAAG
CTTTCGGGTCGCGGGGGCT -> TTTCGGGTCGCGGGGGCTA
CTTTTTGCACCGCAGCCGT -> TTTTTGCACCGCAGCCGTT
TGTGGTGCCTGGTCGTGAA -> GTGGTGCCTGGTCGTGAAA
GCGTTAGGCTTTTTGCACC -> CGTTAGGCTTTTTGCACCG
GCTTGTTATCAGTCGGGTC -> CTTGTTATCAGTCGGGTCG
CCGGAGCCTGGACAGTTTG -> CGGAGCCTGGACAGTTTGG
CAGTCATAAGGTTCGACAG -> AGTCATAAGGTTCGACAGA
AGTACAGGACCTGGGCTTT -> GTACAGGACCTGGGCTTTG
GATTCATGCAAGTCCCTAG -> ATTCATGCAAGTCCCTAGT
AACGACTTGCTGTGGCATT -> ACGACTTGCTGTGGCATTT
TACGCTTGTTATCAGTCGG -> ACGCTTGTTATCAGTCGGG
CGCTTGTTATCAGTCGGGT -> GCTTGTTATCAGTCGGGTC
TCACACCTGAGATGCCAAA -> CACACCTGAGATGCCAAAC
CGTTACTCGTTCTGCCCGC -> GTTACTCGTTCTGCCCGCT
TCTCTTTGCCGACGACAGG -> CTCTTTGCCGACGACAGGT
CTCACTCGTTCGAGATATG -> TCACTCGTTCGAGATATGC
GCGACCGGTAATGGCGGTG -> CGACCGGTAATGGCGGTGC
AGTAAGGATTACAGCGACC -> GTAAGGATTACAGCGACCG
CTTCGTTACTCGTTCTGCC -> TTCGTTACTCGTTCTGCCC
CCTGGTCGTGAAACCAAGC -> CTGGTCGTGAAACCAAGCT
TATTCAAGTGTGTCCGAGC -> ATTCAAGTGTGTCCGAGCC
CCGACGACAGGTGCTTGTA -> CGACGACAGGTGCTTGTAC
TTCTGCCCGCTCCTTCTAA -> TCTGCCCGCTCCTTCTAAG
GGCTACCCATGTAAGACGT -> GCTACCCATGTAAGACGTG
TCCCGCTTATACGTACCGG -> CCCGCTTATACGTACCGGC
CTCCTTCTAAGTTTCTGGC -> TCCTTCTAAGTTTCTGGCC
ATCCCTACTCGCCAACACA -> TCCCTACTCGCCAACACAA
TTCTTCATTACAGCAGCGA -> TCTTCATTACAGCAGCGAT
CGCTAAGGCAGTCATAAGG -> GCTAAGGCAGTCATAAGGT
ACCAAAAGACAAGTTTCAC -> CCAAAAGACAAGTTTCACT
TAGTTAGACGCTTAGCAAG -> AGTTAGACGCTTAGCAAGG
CGATCAGCACACCGTCAGC -> GATCAGCACACCGTCAGCC
GAGAGTAAGGATTACAGCG -> AGAGTAAGGATTACAGCGA
TGCTGTGACAGCGAGCCTC -> GCTGTGACAGCGAGCCTCC
GAACCAGCTCCCGCTTATA -> AACCAGCTCCCGCTTATAC
ACAGCGGGATTCATGCAAG -> CAGCGGGATTCATGCAAGT
TACCTCCGGACTAACTAAC -> ACCTCCGGACTAACTAACG
GAGACGAGGTCACCACGTT -> AGACGAGGTCACCACGTTC
CAAGGGTTCCAATAGGATA -> AAGGGTTCCAATAGGATAT
TGGCAAATTGTGCTCCGTA -> GGCAAATTGTGCTCCGTAT
TCTACGGAACCAGCTCCCG -> CTACGGAACCAGCTCCCGC
GCTGTGGCATTTGTAGACC -> CTGTGGCATTTGTAGACCG
CCTGACAAGGATAAGCCCG -> CTGACAAGGATAAGCCCGG
ATCAGGTAACCCGATTGTT -> TCAGGTAACCCGATTGTTT
CCGCTTATACGACCGTCGC -> CGCTTATACGACCGTCGCA
GTTGGGGCTGAGGCTAAGC -> TTGGGGCTGAGGCTAAGCG
CAGAATGACGGCTTAAGGC -> AGAATGACGGCTTAAGGCT
TACCGTTCACACCTGAGAT -> ACCGTTCACACCTGAGATG
GCTCCCGCTTATACGGTCC -> CTCCCGCTTATACGGTCCT
ATCTCCGACAAGACAGCGG -> TCTCCGACAAGACAGCGGG
CGCCGGAAGCTAACCGTCC -> GCCGGAAGCTAACCGTCCG
TCGAACAAACGATCAGCAT -> CGAACAAACGATCAGCATA
GTGCGTTGGGGCTGAGGCT -> TGCGTTGGGGCTGAGGCTA
GAGAATGCGTTAGGCTTTT -> AGAATGCGTTAGGCTTTTT
TAGGACTACCTGGAGCAGC -> AGGACTACCTGGAGCAGCT
TACGCTTAGATAGAGATAT -> ACGCTTAGATAGAGATATG
TCCTCGGTGGTTTTGGGAG -> CCTCGGTGGTTTTGGGAGC
CCTAAGGAGAGTAAGGATT -> CTAAGGAGAGTAAGGATTA
GAGCAGAATGACGGCTTAA -> AGCAGAATGACGGCTTAAG
CTCACGAGTTTCAAGTTTC -> TCACGAGTTTCAAGTTTCG
ACCCGATTGTTTACCGTTC -> CCCGATTGTTTACCGTTCA
TCAGAGCCCTAAGGAGAGT -> CAGAGCCCTAAGGAGAGTA
CGGTGGCGAGGGGAGAATG -> GGTGGCGAGGGGAGAATGG
CGCTTATACGACCGTCGCA -> GCTTATACGACCGTCGCAT
TGTTGGAGAGTGGTAGGTT -> GTTGGAGAGTGGTAGGTTG
CCATTGCCACGAGTTAGGT -> CATTGCCACGAGTTAGGTA
GTGCCTGGTCGTGAAACCA -> TGCCTGGTCGTGAAACCAA
CCATCACTTCACTTAAAAC -> CATCACTTCACTTAAAACT
CTTAGATAGAGATATGTGG -> TTAGATAGAGATATGTGGT
ACGACTTGCTGTGGCATTT -> CGACTTGCTGTGGCATTTG
CGTTGAGTGGATGTCCAAG -> GTTGAGTGGATGTCCAAGC
AGCGGGCCATTCAGCCTGG -> GCGGGCCATTCAGCCTGGG
CTTAGCAGCCGGCCGGAAG -> TTAGCAGCCGGCCGGAAGC
GACGATCGCTCAAAGCGTC -> ACGATCGCTCAAAGCGTCC
TTTATAGCTGCTAAGAAGT -> TTATAGCTGCTAAGAAGTA
CGGGTCGCGGGGGCTACCG -> GGGTCGCGGGGGCTACCGT,GGGTCGCGGGGGCTACCGC
AGACAGCGGGATTCATGCA -> GACAGCGGGATTCATGCAA
CAGCGAGCCTCCTCGGTGG -> AGCGAGCCTCCTCGGTGGT
CTTGCTTCGAGTAGATGGT -> TTGCTTCGAGTAGATGGTT
GACAAGACAGCGGGATTCA -> ACAAGACAGCGGGATTCAT
TTTGGGAGCGGTGACGATC -> TTGGGAGCGGTGACGATCG
TCAGGTAACCCGATTGTTT -> CAGGTAACCCGATTGTTTA
TTTCCAACATTTATAGCTG -> TTCCAACATTTATAGCTGC
TGACGGCTTAAGGCTTGTT -> GACGGCTTAAGGCTTGTTT
CCCGCTCCTTCTAAGTTTC -> CCGCTCCTTCTAAGTTTCT
GCGGGGGCTACCGTTCGGT -> CGGGGGCTACCGTTCGGTG
TGAGGAAGGCTTTATGACA -> GAGGAAGGCTTTATGACAA
GCACACCGTCAGCCCGGCT -> CACACCGTCAGCCCGGCTG
GCTACTCTTGAGCCTTGCG -> CTACTCTTGAGCCTTGCGC
AGGTCACCACGTTCCTGAC -> GGTCACCACGTTCCTGACA
TGAGTCTAGCCGTACGCTT -> GAGTCTAGCCGTACGCTTA
AGGAGAGTAAGGATTACAG -> GGAGAGTAAGGATTACAGC
GCCGGTCCCTTCAAGCACA -> CCGGTCCCTTCAAGCACAG
ATGGAACCAGGCGTCCATT -> TGGAACCAGGCGTCCATTG
CTTGTACCATAGTCAGTAC -> TTGTACCATAGTCAGTACA
AAGGCTTTATGACAACGAA -> AGGCTTTATGACAACGAAG
TCCATTGCCACGAGTTAGG -> CCATTGCCACGAGTTAGGT
CATATCTGAGTCTAGCCGT -> ATATCTGAGTCTAGCCGTA
AGCTATTTGATTTACTCTC -> GCTATTTGATTTACTCTCT
CCAATACGATGCTGTGACA -> CAATACGATGCTGTGACAG
CCTACTCGCCAACACAAGT -> CTACTCGCCAACACAAGTT
TTATGACAACGAAGGGACC -> TATGACAACGAAGGGACCG
AGTTAGGATAAGAAGGACT -> GTTAGGATAAGAAGGACTT
TCCATCTCGTCCGGAACCT -> CCATCTCGTCCGGAACCTT
GTCATCCGTTTGTTGGAGA -> TCATCCGTTTGTTGGAGAG
GGTCGCGGGGGCTACCGCC -> GTCGCGGGGGCTACCGCCG
CTTATACGTACCGGCTCTT -> TTATACGTACCGGCTCTTT
AGAATGACGGCTTAAGGCT -> GAATGACGGCTTAAGGCTT
GCACGCCGCCATTATCGGT -> CACGCCGCCATTATCGGTG
GGCCGATCAGCACACCGTC -> GCCGATCAGCACACCGTCA
CTCCGGACTAACTAACGAG -> TCCGGACTAACTAACGAGG
CCCTTCAAGCACAGCTAGT -> CCTTCAAGCACAGCTAGTC
GGATACGAATAGTTTCCAA -> GATACGAATAGTTTCCAAC
GGCGTTGAGTGGATGTCCA -> GCGTTGAGTGGATGTCCAA
ACAGAAATCAGGTAACCCG -> CAGAAATCAGGTAACCCGA
CAATAGGATATCCCTCATA -> AATAGGATATCCCTCATAA
GTTTACCGTTCACACCTGA -> TTTACCGTTCACACCTGAG
CGCGGGGGCTACCACGATA -> GCGGGGGCTACCACGATAT
TCGACTTAAGCCCGTACCC -> CGACTTAAGCCCGTACCCC
CTGACAAGGATAAGCCCGG -> TGACAAGGATAAGCCCGGC
TGCCGGTCCCTTCAAGCAC -> GCCGGTCCCTTCAAGCACA
AGTCGGGTCGCGGGGGCTA -> GTCGGGTCGCGGGGGCTAC
TCAGCATAGTAGTTAGACG -> CAGCATAGTAGTTAGACGC
GGTGGTTTTGGGAGCGGTG -> GTGGTTTTGGGAGCGGTGA
ACCGTCCGGATTCATGTCA -> CCGTCCGGATTCATGTCAT
CACACCGTCAGCCCGGCTG -> ACACCGTCAGCCCGGCTGG
TCAGCTACTCTTGAGCCTT -> CAGCTACTCTTGAGCCTTG
GTGACAAACACAGCTCCAG -> TGACAAACACAGCTCCAGC
ACAGCGACCGGTAATGGCG -> CAGCGACCGGTAATGGCGG
AGGGACCGAGCAGAATGAC -> GGGACCGAGCAGAATGACG
TCACTCTTCTTCATTACAG -> CACTCTTCTTCATTACAGC
CTGAAGAACTGATCTTCGC -> TGAAGAACTGATCTTCGCT
TAACGGTACATGGGTGCGA -> AACGGTACATGGGTGCGAG
CAAGCTCTATTTGCCTTTC -> AAGCTCTATTTGCCTTTCA
CGTTAGGCTTTTTGCACCG -> GTTAGGCTTTTTGCACCGC
GGACTAACTAACGAGGTGT -> GACTAACTAACGAGGTGTA
GCTTATACGTACCGGCTCT -> CTTATACGTACCGGCTCTT
ATCGCTCAAAGCGTCCGAA -> TCGCTCAAAGCGTCCGAAA
ACCTGAGATGCCAAACATT -> CCTGAGATGCCAAACATTA
TCAGGATACCCTACTTTCA -> CAGGATACCCTACTTTCAT
CAGGATACCCTACTTTCAT -> AGGATACCCTACTTTCATG
TCAGTACAGGACCTGGGCT -> CAGTACAGGACCTGGGCTT
TACGCCCTGAGCGTTTCGC -> ACGCCCTGAGCGTTTCGCG
ACTCGAACAAACGATCAGC -> CTCGAACAAACGATCAGCA
TTCAAGTTTCGACTTAAGC -> TCAAGTTTCGACTTAAGCC
AGGACCTGGGCTTTGGAGC -> GGACCTGGGCTTTGGAGCC
TCCGGAACCTTGCTTCGTT -> CCGGAACCTTGCTTCGTTA
TACTGTTCTCGTTATGACA -> ACTGTTCTCGTTATGACAC
TCAGGATCAGCTACTCTTG -> CAGGATCAGCTACTCTTGA
AATACCTGGGGAGTGACAA -> ATACCTGGGGAGTGACAAA
ACTCATAGCGGGCCATTCA -> CTCATAGCGGGCCATTCAG
TACTGAGCTATTTGATTTA -> ACTGAGCTATTTGATTTAC
ACAGGTCGGTGGATACGAA -> CAGGTCGGTGGATACGAAT
TCGTTCTGCCCGCTCCTTC -> CGTTCTGCCCGCTCCTTCT
AGGAGAATGTGAGCTAACG -> GGAGAATGTGAGCTAACGG
TACTTTCATGGAATCACAC -> ACTTTCATGGAATCACACA
GGCAGTCGAAAAGAATAGC -> GCAGTCGAAAAGAATAGCC
CCAAACATTAGATGAAGTA -> CAAACATTAGATGAAGTAA
CCCACTTGCTTCGAGTAGA -> CCACTTGCTTCGAGTAGAT
TAATGGCGGTGCGTTGGGG -> AATGGCGGTGCGTTGGGGC
CGGCTTTGAACGCAATGAG -> GGCTTTGAACGCAATGAGA
GTGGTAGGTTGATCCATCT -> TGGTAGGTTGATCCATCTC
CAAAAGACAAGTTTCACTC -> AAAAGACAAGTTTCACTCT
TAGCCCAAAGTCCCCACTT -> AGCCCAAAGTCCCCACTTG
ACATTAGATGAAGTAAATT -> CATTAGATGAAGTAAATTG
TTTCAGGATACCCTACTTT -> TTCAGGATACCCTACTTTC
TAGCTGCTAAGAAGTATCG -> AGCTGCTAAGAAGTATCGT
CGACTTGCTGTGGCATTTG -> GACTTGCTGTGGCATTTGT
TTCAAGCACAGCTAGTCTT -> TCAAGCACAGCTAGTCTTT
TATGTGGTCCCGTGCGTCC -> ATGTGGTCCCGTGCGTCCT
GATCAGCACACCGTCAGCC -> ATCAGCACACCGTCAGCCC
GTCCATTGCCACGAGTTAG -> TCCATTGCCACGAGTTAGG
GAAGGCTTTATGACAACGA -> AAGGCTTTATGACAACGAA
TCCGGCACTAGGCGTCAAC -> CCGGCACTAGGCGTCAACT
CTCTTCTTCATTACAGCAG -> TCTTCTTCATTACAGCAGC
GATGTCCAAGCTTCGCCAG -> ATGTCCAAGCTTCGCCAGC
TAGCGGGCCATTCAGCCTG -> AGCGGGCCATTCAGCCTGG
GTTCCAATAGGATATCCCT -> TTCCAATAGGATATCCCTC
ATAGCTGCTAAGAAGTATC -> TAGCTGCTAAGAAGTATCG
TCGTTACTCGTTCTGCCCG -> CGTTACTCGTTCTGCCCGC
TACAGGACCTGGGCTTTGG -> ACAGGACCTGGGCTTTGGA
TGCACTGGGCGTGTAACGT -> GCACTGGGCGTGTAACGTC
CCGCGTAGACGATCGAACA -> CGCGTAGACGATCGAACAC
ATTGCCACGAGTTAGGTAC -> TTGCCACGAGTTAGGTACG
AGGATATCCCTCATAATCC -> GGATATCCCTCATAATCCC
CTACCGTTCGGTGTATAGG -> TACCGTTCGGTGTATAGGG
CCGGAAGCGCAGTCGTTGC -> CGGAAGCGCAGTCGTTGCC
TTCCTGACAAGGATAAGCC -> TCCTGACAAGGATAAGCCC
CCACTGAAGAACTGATCTT -> CACTGAAGAACTGATCTTC
CGGGTCGCGGGGGCTACCC -> GGGTCGCGGGGGCTACCCA
CCGTCCCGGCCAAACGGGG -> CGTCCCGGCCAAACGGGGT
CGGGGTCAGCAGGCGGCAG -> GGGGTCAGCAGGCGGCAGT
AAGGGACCGAGCAGAATGA -> AGGGACCGAGCAGAATGAC
TGGCGGTGCGTTGGGGCTG -> GGCGGTGCGTTGGGGCTGA
AGTAAATTGAGAGTCTGCT -> GTAAATTGAGAGTCTGCTC
GTGCTTGTACCATAGTCAG -> TGCTTGTACCATAGTCAGT
AAAACTCGCAACTAAATAC -> AAACTCGCAACTAAATACC
GGGGAGAATGGAACCAGGC -> GGGAGAATGGAACCAGGCG
CCAATAGGATATCCCTCAT -> CAATAGGATATCCCTCATA
GTTTGGCACGCCGCCATTA -> TTTGGCACGCCGCCATTAT
CGGGCCATTCAGCCTGGGT -> GGGCCATTCAGCCTGGGTG
TAACTCACGAGTTTCAAGT -> AACTCACGAGTTTCAAGTT
ACGATCGAACACTCCTTTA -> CGATCGAACACTCCTTTAA
GGGAGTGACAAACACAGCT -> GGAGTGACAAACACAGCTC
CAGAGCAAGTGAGTCTCAA -> AGAGCAAGTGAGTCTCAAT
TAGCAGCCGGCCGGAAGCG -> AGCAGCCGGCCGGAAGCGC
CTTCACTTAAAACTCGCAA -> TTCACTTAAAACTCGCAAC
ACCGTTCACACCTGAGATG -> CCGTTCACACCTGAGATGC
CTACTCGCCAACACAAGTT -> TACTCGCCAACACAAGTTG
CCTACTTTCATGGAATCAC -> CTACTTTCATGGAATCACA
AGCAGCGATCCGTAGCATC -> GCAGCGATCCGTAGCATCC
ACAAACGATCAGCATAGTA -> CAAACGATCAGCATAGTAG
ACTTAAAACTCGCAACTAA -> CTTAAAACTCGCAACTAAA
GCTTATACGACCGTCGCAT -> CTTATACGACCGTCGCATA
CGTTCTGCCCGCTCCTTCT -> GTTCTGCCCGCTCCTTCTA
TCGCAACTAAATACCTGGG -> CGCAACTAAATACCTGGGG
CAAACATTAGATGAAGTAA -> AAACATTAGATGAAGTAAA
GCAGTCATAAGGTTCGACA -> CAGTCATAAGGTTCGACAG
ATTTATAGCTGCTAAGAAG -> TTTATAGCTGCTAAGAAGT
CTCATAGCGGGCCATTCAG -> TCATAGCGGGCCATTCAGC
TGCTGAAGTACTGTTCTCG -> GCTGAAGTACTGTTCTCGT
GGTGCCTGGTCGTGAAACC -> GTGCCTGGTCGTGAAACCA
GAGCCTCCTCGGTGGTTTT -> AGCCTCCTCGGTGGTTTTG
AATGAGATCCTATACGTCA -> ATGAGATCCTATACGTCAT
AATGCGTTAGGCTTTTTGC -> ATGCGTTAGGCTTTTTGCA
GGGGTCAGCAGGCGGCAGT -> GGGTCAGCAGGCGGCAGTC
TATCTGAGTCTAGCCGTAC -> ATCTGAGTCTAGCCGTACG
GAAGCTAACCGTCCGGATT -> AAGCTAACCGTCCGGATTC
TCCCTGCTGAAGTACTGTT -> CCCTGCTGAAGTACTGTTC
AAGTTTCACTCTTCTTCAT -> AGTTTCACTCTTCTTCATT
CAAAACGGTTCCATAAGAG -> AAAACGGTTCCATAAGAGA
TCAATAAAGTACTGAGCTA -> CAATAAAGTACTGAGCTAT
GCCACTCATAGCGGGCCAT -> CCACTCATAGCGGGCCATT
GCTTCTCGCCGGAAGCTAA -> CTTCTCGCCGGAAGCTAAC
CCTGGACAGTTTGGACTAC -> CTGGACAGTTTGGACTACC
CTCCCGCTTATACGCTTGT -> TCCCGCTTATACGCTTGTT
CAACACAAGTTGCGGTGAG -> AACACAAGTTGCGGTGAGG
GGAGCCTGACATCGCCTAT -> GAGCCTGACATCGCCTATA
AAGTTTCTGGCCGATCAGC -> AGTTTCTGGCCGATCAGCA
TGAGTGGATGTCCAAGCTT -> GAGTGGATGTCCAAGCTTC
CGGTAATGGCGGTGCGTTG -> GGTAATGGCGGTGCGTTGG
GGGTCGCGGGGGCTACCCA -> GGTCGCGGGGGCTACCCAT
TTCGGGTCGCGGGGGCTAC -> TCGGGTCGCGGGGGCTACC
GCCCGGCTTTGAACGCAAT -> CCCGGCTTTGAACGCAATG
CTCCTTTAACTCACGAGTT -> TCCTTTAACTCACGAGTTT
TTGCCCAATACGATGCTGT -> TGCCCAATACGATGCTGTG
GCTACCGTTCGGTGTATAG -> CTACCGTTCGGTGTATAGG
ACGTGTGGGACCTGTAGGA -> CGTGTGGGACCTGTAGGAT
GATTACAGCGACCGGTAAT -> ATTACAGCGACCGGTAATG
TCGGTGGTTTTGGGAGCGG -> CGGTGGTTTTGGGAGCGGT
CTGCCCGCTCCTTCTAAGT -> TGCCCGCTCCTTCTAAGTT
ACACAAGGAGCTGTCGACT -> CACAAGGAGCTGTCGACTA
TGGAACCAGGCGTCCATTG -> GGAACCAGGCGTCCATTGC
TGGACTACCAAAAGACAAG -> GGACTACCAAAAGACAAGT
CTCCCGCTTATACGACCGT -> TCCCGCTTATACGACCGTC
AGATAGAGATATGTGGTCC -> GATAGAGATATGTGGTCCC
GACAAGTTTCACTCTTCTT -> ACAAGTTTCACTCTTCTTC
CGAACAAACGATCAGCATA -> GAACAAACGATCAGCATAG
AAGGATAAGCCCGGCTTTG -> AGGATAAGCCCGGCTTTGA
CGAAAAGAATAGCCCAAAG -> GAAAAGAATAGCCCAAAGT
TTCATGGAATCACACACAA -> TCATGGAATCACACACAAG
TGGTCGTGAAACCAAGCTC -> GGTCGTGAAACCAAGCTCT
GGGACCGAGCAGAATGACG -> GGACCGAGCAGAATGACGG
AAAGAATAGCCCAAAGTCC -> AAGAATAGCCCAAAGTCCC
TGGATGTCCAAGCTTCGCC -> GGATGTCCAAGCTTCGCCA
TGGGCGTGTAACGTCTGAT -> GGGCGTGTAACGTCTGATC
TGAGAGTCTGCTCAGAGCC -> GAGAGTCTGCTCAGAGCCC
ATGCGTTAGGCTTTTTGCA -> TGCGTTAGGCTTTTTGCAC
CCTGGGCTTTGGAGCCTGA -> CTGGGCTTTGGAGCCTGAC
TATGACAACGAAGGGACCG -> ATGACAACGAAGGGACCGA
AAGAATAGCCCAAAGTCCC -> AGAATAGCCCAAAGTCCCC
AGTCCCCACTTGCTTCGAG -> GTCCCCACTTGCTTCGAGT
TACGAATAGTTTCCAACAT -> ACGAATAGTTTCCAACATT
CGTTTGTTGGAGAGTGGTA -> GTTTGTTGGAGAGTGGTAG
TCCTTTAACTCACGAGTTT -> CCTTTAACTCACGAGTTTC
ACGCAATGAGATCCTATAC -> CGCAATGAGATCCTATACG
GAGCCTTGCGCTCTACACC -> AGCCTTGCGCTCTACACCG
CGAGGGGAGAATGGAACCA -> GAGGGGAGAATGGAACCAG
TGAGATGCCAAACATTAGA -> GAGATGCCAAACATTAGAT
CTGGGCTTTGGAGCCTGAC -> TGGGCTTTGGAGCCTGACA
GGTTGATCCATCTCGTCCG -> GTTGATCCATCTCGTCCGG
GATATCCCTCATAATCCCG -> ATATCCCTCATAATCCCGG
GTACCTCCGGACTAACTAA -> TACCTCCGGACTAACTAAC
CGTGAAACCAAGCTCTATT -> GTGAAACCAAGCTCTATTT
CCAAAAGACAAGTTTCACT -> CAAAAGACAAGTTTCACTC
GGATACCCTACTTTCATGG -> GATACCCTACTTTCATGGA
TCACGAGTTTCAAGTTTCG -> CACGAGTTTCAAGTTTCGA
GCAAGTGAGTCTCAATAAA -> CAAGTGAGTCTCAATAAAG
CGCCAGCTCCCGCTTATAC -> GCCAGCTCCCGCTTATACG
GGACCTGGGCTTTGGAGCC -> GACCTGGGCTTTGGAGCCT
CCCCACTTGCTTCGAGTAG -> CCCACTTGCTTCGAGTAGA
TGTTTGGCACGCCGCCATT -> GTTTGGCACGCCGCCATTA
TGGACAGTTTGGACTACCA -> GGACAGTTTGGACTACCAA
GAACTGATCTTCGCTCCCT -> AACTGATCTTCGCTCCCTG
CCTTAGCAGCCGGCCGGAA -> CTTAGCAGCCGGCCGGAAG
GATCGCTCAAAGCGTCCGA -> ATCGCTCAAAGCGTCCGAA
TGGAGGATAACCCACTGAA -> GGAGGATAACCCACTGAAG
CAGGCGGCAGTCGAAAAGA -> AGGCGGCAGTCGAAAAGAA
CTGTGACAGCGAGCCTCCT -> TGTGACAGCGAGCCTCCTC
TGGGGCTGAGGCTAAGCGC -> GGGGCTGAGGCTAAGCGCG
ACTCTCTTTGCCGACGACA -> CTCTCTTTGCCGACGACAG
CGACAGAGAGAGACAGAAA -> GACAGAGAGAGACAGAAAT
CACTCGTTCGAGATATGCA -> ACTCGTTCGAGATATGCAC
AACGGTTCCATAAGAGACG -> ACGGTTCCATAAGAGACGA
TAACCCGATTGTTTACCGT -> AACCCGATTGTTTACCGTT
ACCCACTGAAGAACTGATC -> CCCACTGAAGAACTGATCT
ATATGCACTGGGCGTGTAA -> TATGCACTGGGCGTGTAAC
TGTGGCAAATTGTGCTCCG -> GTGGCAAATTGTGCTCCGT
TACCCTACTTTCATGGAAT -> ACCCTACTTTCATGGAATC
CGCGCAGAGCAAGTGAGTC -> GCGCAGAGCAAGTGAGTCT
GATAGAGATATGTGGTCCC -> ATAGAGATATGTGGTCCCG
GCGGCAGTCGAAAAGAATA -> CGGCAGTCGAAAAGAATAG
GAAACAGCTAGCTACGCCC -> AAACAGCTAGCTACGCCCT
TAGCCGTACGCTTAGATAG -> AGCCGTACGCTTAGATAGA
CAAGTGAGTCTCAATAAAG -> AAGTGAGTCTCAATAAAGT
CAGAGAGAGACAGAAATCA -> AGAGAGAGACAGAAATCAG
CTACTTTCATGGAATCACA -> TACTTTCATGGAATCACAC
ATAAGGTTCGACAGAGAGA -> TAAGGTTCGACAGAGAGAG
CGAGTCCGGTGTGGTGCCT -> GAGTCCGGTGTGGTGCCTG
AGCGTCCGAAACAGCTAGC -> GCGTCCGAAACAGCTAGCT
ATCAGCACACCGTCAGCCC -> TCAGCACACCGTCAGCCCG
GAATGGAACCAGGCGTCCA -> AATGGAACCAGGCGTCCAT
ACGATCGCTCAAAGCGTCC -> CGATCGCTCAAAGCGTCCG
GTCAGCAGGCGGCAGTCGA -> TCAGCAGGCGGCAGTCGAA
CACCGCAGCCGTTCAAAAC -> ACCGCAGCCGTTCAAAACG
GGCTACCGCCGCTACTCTG -> GCTACCGCCGCTACTCTGT
CAATACGATGCTGTGACAG -> AATACGATGCTGTGACAGC
CCTTGCTTCGTTACTCGTT -> CTTGCTTCGTTACTCGTTC
CGGTGTGGTGCCTGGTCGT -> GGTGTGGTGCCTGGTCGTG
AGCATAGTAGTTAGACGCT -> GCATAGTAGTTAGACGCTT
CGTCATCCGTTTGTTGGAG -> GTCATCCGTTTGTTGGAGA
CCCGGCTGGAGGATAACCC -> CCGGCTGGAGGATAACCCA
TGATCTCCATCACTTCACT -> GATCTCCATCACTTCACTT
GAACCTTGCTTCGTTACTC -> AACCTTGCTTCGTTACTCG
GCTTCGTTACTCGTTCTGC -> CTTCGTTACTCGTTCTGCC
GTCCAAGCTTCGCCAGCTC -> TCCAAGCTTCGCCAGCTCC
GAGGAAGGCTTTATGACAA -> AGGAAGGCTTTATGACAAC
GGTGCCCATATCTGAGTCT -> GTGCCCATATCTGAGTCTA
TGCGTTGGGGCTGAGGCTA -> GCGTTGGGGCTGAGGCTAA
CTGATCTCCATCACTTCAC -> TGATCTCCATCACTTCACT
AATAGCCCAAAGTCCCCAC -> ATAGCCCAAAGTCCCCACT
GAAGTAAATTGAGAGTCTG -> AAGTAAATTGAGAGTCTGC
TTCAAAACGGTTCCATAAG -> TCAAAACGGTTCCATAAGA
GATTCATGTCATGCCGGTC -> ATTCATGTCATGCCGGTCC
GACGCCTGGGCGTTGAGTG -> ACGCCTGGGCGTTGAGTGG
AGCTATCTCCGACAAGACA -> GCTATCTCCGACAAGACAG
GAACGCAATGAGATCCTAT -> AACGCAATGAGATCCTATA
GCCTGGGTGCCCATATCTG -> CCTGGGTGCCCATATCTGA
AGAGTGGTAGGTTGATCCA -> GAGTGGTAGGTTGATCCAT
CGGGGGCTACCGTTCGGTG -> GGGGGCTACCGTTCGGTGT
GATTACCCAAGAATCTACT -> ATTACCCAAGAATCTACTC
ATAGTTTCCAACATTTATA -> TAGTTTCCAACATTTATAG
AGCTAGCTACGCCCTGAGC -> GCTAGCTACGCCCTGAGCG
TGCACCGCAGCCGTTCAAA -> GCACCGCAGCCGTTCAAAA
AGAGCCCTAAGGAGAGTAA -> GAGCCCTAAGGAGAGTAAG
TAGGAGAATGCGTTAGGCT -> AGGAGAATGCGTTAGGCTT
GAGTCTGCTCAGAGCCCTA -> AGTCTGCTCAGAGCCCTAA
ACGAGGTGTACTTCTACGG -> CGAGGTGTACTTCTACGGA
GCGAGCCTCCTCGGTGGTT -> CGAGCCTCCTCGGTGGTTT
CAAGTGTGTCCGAGCCACT -> AAGTGTGTCCGAGCCACTC
CAGCAGGCGGCAGTCGAAA -> AGCAGGCGGCAGTCGAAAA
GCTACCACGATATCCGGCA -> CTACCACGATATCCGGCAC
GTACTGAGCTATTTGATTT -> TACTGAGCTATTTGATTTA
ATCCATCTCGTCCGGAACC -> TCCATCTCGTCCGGAACCT
TATACGCTTGTTATCAGTC -> ATACGCTTGTTATCAGTCG
CCAGCTCCCGCTTATACGA -> CAGCTCCCGCTTATACGAC
CTAAGAAGTATCGTACCTC -> TAAGAAGTATCGTACCTCC
ACACACAAGGAGCTGTCGA -> CACACAAGGAGCTGTCGAC
TATACGTCATCCGTTTGTT -> ATACGTCATCCGTTTGTTG
AATAAAGTACTGAGCTATT -> ATAAAGTACTGAGCTATTT
TCTAGCCGTACGCTTAGAT -> CTAGCCGTACGCTTAGATA
CCATTCAGCCTGGGTGCCC -> CATTCAGCCTGGGTGCCCA
ACTTGCTGTGGCATTTGTA -> CTTGCTGTGGCATTTGTAG
TAAGCCCGTACCCCCAGCT -> AAGCCCGTACCCCCAGCTC
CGGCCAAACGGGGTCAGCA -> GGCCAAACGGGGTCAGCAG
ATTTACTCTCTTTGCCGAC -> TTTACTCTCTTTGCCGACG
CTTGCTTCGTTACTCGTTC -> TTGCTTCGTTACTCGTTCT
CGTTGCCCAATACGATGCT -> GTTGCCCAATACGATGCTG
GTCGCGGGGGCTACCGCCG -> TCGCGGGGGCTACCGCCGC
GAGGTCACCACGTTCCTGA -> AGGTCACCACGTTCCTGAC
CCCGCTTATACGACCGTCG -> CCGCTTATACGACCGTCGC
ATCCGTAGCATCCCTACTC -> TCCGTAGCATCCCTACTCG
CCGGTCGGGTCGCGGGGGC -> CGGTCGGGTCGCGGGGGCT
AAGACGTGTGGGACCTGTA -> AGACGTGTGGGACCTGTAG
GGGTTCCAATAGGATATCC -> GGTTCCAATAGGATATCCC
AAGGCAGTCATAAGGTTCG -> AGGCAGTCATAAGGTTCGA
GAATGTGAGCTAACGGTAC -> AATGTGAGCTAACGGTACA
AAGGAGCTGTCGACTAGGA -> AGGAGCTGTCGACTAGGAG
CAGCTCCCGCTTATACGGT -> AGCTCCCGCTTATACGGTC
TCATAAGGTTCGACAGAGA -> CATAAGGTTCGACAGAGAG
CGACTAGGAGAATGTGAGC -> GACTAGGAGAATGTGAGCT
AGTGGATGTCCAAGCTTCG -> GTGGATGTCCAAGCTTCGC
AACATTTATAGCTGCTAAG -> ACATTTATAGCTGCTAAGA
ACCGAGCAGAATGACGGCT -> CCGAGCAGAATGACGGCTT
CGTCTGATCTCCATCACTT -> GTCTGATCTCCATCACTTC
AAAGACAAGTTTCACTCTT -> AAGACAAGTTTCACTCTTC
GCTTATACGGTCCTGGCCG -> CTTATACGGTCCTGGCCGG
GACCTGGGCTTTGGAGCCT -> ACCTGGGCTTTGGAGCCTG
CTTCGCTCCCTGCTGAAGT -> TTCGCTCCCTGCTGAAGTA
TCTTTAACGACTTGCTGTG -> CTTTAACGACTTGCTGTGG
CTGGAGCAGCTTCTCGCCG -> TGGAGCAGCTTCTCGCCGG
CCAGCTCCCGCTTATACGT -> CAGCTCCCGCTTATACGTA
TACCATAGTCAGTACAGGA -> ACCATAGTCAGTACAGGAC
GTGATTACCCAAGAATCTA -> TGATTACCCAAGAATCTAC
AGTTAGGTACGCGCCGCAC -> GTTAGGTACGCGCCGCACT
AGTCTTTAACGACTTGCTG -> GTCTTTAACGACTTGCTGT
CCGCCGCTACTCTGTAGGA -> CGCCGCTACTCTGTAGGAC
AACCCACTGAAGAACTGAT -> ACCCACTGAAGAACTGATC
CCGGCACTAGGCGTCAACT -> CGGCACTAGGCGTCAACTC
AATCCCGGAGCCTGGACAG -> ATCCCGGAGCCTGGACAGT
CCAAGCTCTATTTGCCTTT -> CAAGCTCTATTTGCCTTTC
GGGTCAGCAGGCGGCAGTC -> GGTCAGCAGGCGGCAGTCG
CAGATCAGGATCAGCTACT -> AGATCAGGATCAGCTACTC
TAAATTGAGAGTCTGCTCA -> AAATTGAGAGTCTGCTCAG
GTCTCAATAAAGTACTGAG -> TCTCAATAAAGTACTGAGC
GAACACTCCTTTAACTCAC -> AACACTCCTTTAACTCACG
GTATTCAAGTGTGTCCGAG -> TATTCAAGTGTGTCCGAGC
GTCGCGGGGGCTACCACGA -> TCGCGGGGGCTACCACGAT
CCCAAAGTCCCCACTTGCT -> CCAAAGTCCCCACTTGCTT
GAGATATGTGGTCCCGTGC -> AGATATGTGGTCCCGTGCG
ATATCCCTCATAATCCCGG -> TATCCCTCATAATCCCGGA
CCGTTATTTTTCAGGATAC -> CGTTATTTTTCAGGATACC
GCCAAACATTAGATGAAGT -> CCAAACATTAGATGAAGTA
GCCTGGGCGTTGAGTGGAT -> CCTGGGCGTTGAGTGGATG
TGAAGTACTGTTCTCGTTA -> GAAGTACTGTTCTCGTTAT
AGATGCCAAACATTAGATG -> GATGCCAAACATTAGATGA
GGAGCAGCTTCTCGCCGGA -> GAGCAGCTTCTCGCCGGAA
GGTCGCGGGGGCTACCACG -> GTCGCGGGGGCTACCACGA
CGCAACTAAATACCTGGGG -> GCAACTAAATACCTGGGGA
TCCTGGCCGGTCGGGTCGC -> CCTGGCCGGTCGGGTCGCG
CCGAGCCACTCATAGCGGG -> CGAGCCACTCATAGCGGGC
GCTTTGAACGCAATGAGAT -> CTTTGAACGCAATGAGATC
TTAGCAGCCGGCCGGAAGC -> TAGCAGCCGGCCGGAAGCG
TACGCGCCGCACTAGGAGA -> ACGCGCCGCACTAGGAGAA
GTTGCGGTGAGGAAGGCTT -> TTGCGGTGAGGAAGGCTTT
GTTGAGTGGATGTCCAAGC -> TTGAGTGGATGTCCAAGCT
AGAGACGAGGTCACCACGT -> GAGACGAGGTCACCACGTT
TGGAGCAGCTTCTCGCCGG -> GGAGCAGCTTCTCGCCGGA
TGCGGTGAGGAAGGCTTTA -> GCGGTGAGGAAGGCTTTAT
CTACTCGAACAAACGATCA -> TACTCGAACAAACGATCAG
GCGTCCATTGCCACGAGTT -> CGTCCATTGCCACGAGTTA
AGAGACAGAAATCAGGTAA -> GAGACAGAAATCAGGTAAC
ATATCGGGTCGCGGGGGCT -> TATCGGGTCGCGGGGGCTA
GACAGTTTGGACTACCAAA -> ACAGTTTGGACTACCAAAA
TCACTCGTTCGAGATATGC -> CACTCGTTCGAGATATGCA
TGACAGCGAGCCTCCTCGG -> GACAGCGAGCCTCCTCGGT
TTCCAACATTTATAGCTGC -> TCCAACATTTATAGCTGCT
GGTCGCGGGGGCTACCGTT -> GTCGCGGGGGCTACCGTTC
TCCGTAGCATCCCTACTCG -> CCGTAGCATCCCTACTCGC
TCTCGCCGGAAGCTAACCG -> CTCGCCGGAAGCTAACCGT
GCGTCCTTTCAGATCAGGA -> CGTCCTTTCAGATCAGGAT
CAGCGACCGGTAATGGCGG -> AGCGACCGGTAATGGCGGT
CCATGTAAGACGTGTGGGA -> CATGTAAGACGTGTGGGAC
AGAGCAAGTGAGTCTCAAT -> GAGCAAGTGAGTCTCAATA
ACTAGGAGAATGTGAGCTA -> CTAGGAGAATGTGAGCTAA
GGGCCATTCAGCCTGGGTG -> GGCCATTCAGCCTGGGTGC
CCTGACATCGCCTATAATC -> CTGACATCGCCTATAATCG
CGTTCCTGACAAGGATAAG -> GTTCCTGACAAGGATAAGC
CGGCTGGAGGATAACCCAC -> GGCTGGAGGATAACCCACT
GCTACCCATGTAAGACGTG -> CTACCCATGTAAGACGTGT
GTGAGGAAGGCTTTATGAC -> TGAGGAAGGCTTTATGACA
GGCAAATTGTGCTCCGTAT -> GCAAATTGTGCTCCGTATT
GGAATCACACACAAGGAGC -> GAATCACACACAAGGAGCT
GGAGCTGTCGACTAGGAGA -> GAGCTGTCGACTAGGAGAA
TCCAGCTCCCGCTTATACG -> CCAGCTCCCGCTTATACGT
TACGACCGTCGCATATCGG -> ACGACCGTCGCATATCGGG
CTCCGACAAGACAGCGGGA -> TCCGACAAGACAGCGGGAT
ACACAGGTCGGTGGATACG -> CACAGGTCGGTGGATACGA
CACTGAAGAACTGATCTTC -> ACTGAAGAACTGATCTTCG
TCCCTAGTTAGGATAAGAA -> CCCTAGTTAGGATAAGAAG
AGTGAGTCTCAATAAAGTA -> GTGAGTCTCAATAAAGTAC
GTAGTTAGACGCTTAGCAA -> TAGTTAGACGCTTAGCAAG
TAGGATATCCCTCATAATC -> AGGATATCCCTCATAATCC
GTTCAAAACGGTTCCATAA -> TTCAAAACGGTTCCATAAG
TGCCCGCTCCTTCTAAGTT -> GCCCGCTCCTTCTAAGTTT
GCGGTGACGATCGCTCAAA -> CGGTGACGATCGCTCAAAG
TGCTCAGAGCCCTAAGGAG -> GCTCAGAGCCCTAAGGAGA
GGGGCTACCGTTCGGTGTA -> GGGCTACCGTTCGGTGTAT
TGTGCTCCGTATTCAAGTG -> GTGCTCCGTATTCAAGTGT
GACAGCGGGATTCATGCAA -> ACAGCGGGATTCATGCAAG
AGTTTCAAGTTTCGACTTA -> GTTTCAAGTTTCGACTTAA
GAATAGCCCAAAGTCCCCA -> AATAGCCCAAAGTCCCCAC
GTTCACACCTGAGATGCCA -> TTCACACCTGAGATGCCAA
AAGGCTTGTTTGGCACGCC -> AGGCTTGTTTGGCACGCCG
AACTAACGAGGTGTACTTC -> ACTAACGAGGTGTACTTCT
GCATAGTAGTTAGACGCTT -> CATAGTAGTTAGACGCTTA
AGCTCCCGCTTATACGGTC -> GCTCCCGCTTATACGGTCC
TCTTCGCTCCCTGCTGAAG -> CTTCGCTCCCTGCTGAAGT
CGTATTCAAGTGTGTCCGA -> GTATTCAAGTGTGTCCGAG
GCTTCGCCAGCTCCCGCTT -> CTTCGCCAGCTCCCGCTTA
GACTTGACGATCGCTAAGG -> ACTTGACGATCGCTAAGGC
AACCAGCTCCCGCTTATAC -> ACCAGCTCCCGCTTATACG
TTGCACCGCAGCCGTTCAA -> TGCACCGCAGCCGTTCAAA
GGTTTTGGGAGCGGTGACG -> GTTTTGGGAGCGGTGACGA
TGTTATCAGTCGGGTCGCG -> GTTATCAGTCGGGTCGCGG
ATAAGAAGGACTTGACGAT -> TAAGAAGGACTTGACGATC
GGTTCGACAGAGAGAGACA -> GTTCGACAGAGAGAGACAG
ACACCGCGTAGACGATCGA -> CACCGCGTAGACGATCGAA
GGCTTTGAACGCAATGAGA -> GCTTTGAACGCAATGAGAT
GTCCTGGCCGGTCGGGTCG -> TCCTGGCCGGTCGGGTCGC
CTGAGGCTAAGCGCGAATG -> TGAGGCTAAGCGCGAATGG
CTCTACACCGCGTAGACGA -> TCTACACCGCGTAGACGAT
GTACCGGCTCTTTCGGGTC -> TACCGGCTCTTTCGGGTCG
TTCAGCCTGGGTGCCCATA -> TCAGCCTGGGTGCCCATAT
TATACGGTCCTGGCCGGTC -> ATACGGTCCTGGCCGGTCG
AAGAAGTATCGTACCTCCG -> AGAAGTATCGTACCTCCGG
TGTGTCCGAGCCACTCATA -> GTGTCCGAGCCACTCATAG
GCTCAGAGCCCTAAGGAGA -> CTCAGAGCCCTAAGGAGAG
TTGGACTACCAAAAGACAA -> TGGACTACCAAAAGACAAG
TCCGGACTAACTAACGAGG -> CCGGACTAACTAACGAGGT
AAGGGTTCCAATAGGATAT -> AGGGTTCCAATAGGATATC
CCAGGCGTCCATTGCCACG -> CAGGCGTCCATTGCCACGA
AGCTGCTAAGAAGTATCGT -> GCTGCTAAGAAGTATCGTA
CGAGATATGCACTGGGCGT -> GAGATATGCACTGGGCGTG
AGCAGGCGGCAGTCGAAAA -> GCAGGCGGCAGTCGAAAAG
ACTAAATACCTGGGGAGTG -> CTAAATACCTGGGGAGTGA
GCCGCACTAGGAGAATGCG -> CCGCACTAGGAGAATGCGT
TGATTTACTCTCTTTGCCG -> GATTTACTCTCTTTGCCGA
GTCGGTGGATACGAATAGT -> TCGGTGGATACGAATAGTT
GGGCTACCCATGTAAGACG -> GGCTACCCATGTAAGACGT
GGGGAGTGACAAACACAGC -> GGGAGTGACAAACACAGCT
CAAGAATCTACTCGAACAA -> AAGAATCTACTCGAACAAA
TTGATCCATCTCGTCCGGA -> TGATCCATCTCGTCCGGAA
CTTATACGGTCCTGGCCGG -> TTATACGGTCCTGGCCGGT
CGGCTCTTTCGGGTCGCGG -> GGCTCTTTCGGGTCGCGGG
GGATGTGGCAAATTGTGCT -> GATGTGGCAAATTGTGCTC
ATACGAATAGTTTCCAACA -> TACGAATAGTTTCCAACAT
CGGGTCGCGGGGGCTACCA -> GGGTCGCGGGGGCTACCAC
CGATCGCTAAGGCAGTCAT -> GATCGCTAAGGCAGTCATA
TTGCCTTAGCAGCCGGCCG -> TGCCTTAGCAGCCGGCCGG
CGGTACATGGGTGCGAGTC -> GGTACATGGGTGCGAGTCC
TCATGCAAGTCCCTAGTTA -> CATGCAAGTCCCTAGTTAG
AGGATAAGAAGGACTTGAC -> GGATAAGAAGGACTTGACG
AGATATGCACTGGGCGTGT -> GATATGCACTGGGCGTGTA
TAGGCTTTTTGCACCGCAG -> AGGCTTTTTGCACCGCAGC
AGTTTCTGGCCGATCAGCA -> GTTTCTGGCCGATCAGCAC
GTTGCCTTAGCAGCCGGCC -> TTGCCTTAGCAGCCGGCCG
AGCGCAGTCGTTGCCCAAT -> GCGCAGTCGTTGCCCAATA
CACGAGTTAGGTACGCGCC -> ACGAGTTAGGTACGCGCCG
TAATCCCGGAGCCTGGACA -> AATCCCGGAGCCTGGACAG
ATGCTGTGACAGCGAGCCT -> TGCTGTGACAGCGAGCCTC
ACGATCGCTAAGGCAGTCA -> CGATCGCTAAGGCAGTCAT
TATGACACAGGTCGGTGGA -> ATGACACAGGTCGGTGGAT
CCCTGAGCGTTTCGCGCAG -> CCTGAGCGTTTCGCGCAGA
CTGGGTGCCCATATCTGAG -> TGGGTGCCCATATCTGAGT
GATATCCGGCACTAGGCGT -> ATATCCGGCACTAGGCGTC
ATCGGTGGCGAGGGGAGAA -> TCGGTGGCGAGGGGAGAAT
GCAAGGGTTCCAATAGGAT -> CAAGGGTTCCAATAGGATA
GAAGTACTGTTCTCGTTAT -> AAGTACTGTTCTCGTTATG
TTTGTTGGAGAGTGGTAGG -> TTGTTGGAGAGTGGTAGGT
GATGCCAAACATTAGATGA -> ATGCCAAACATTAGATGAA
AGTAGTTAGACGCTTAGCA -> GTAGTTAGACGCTTAGCAA
CGGTGGTTTTGGGAGCGGT -> GGTGGTTTTGGGAGCGGTG
AGGAGAATGCGTTAGGCTT -> GGAGAATGCGTTAGGCTTT
CCCGCTTATACGTACCGGC -> CCGCTTATACGTACCGGCT
GTGACGATCGCTCAAAGCG -> TGACGATCGCTCAAAGCGT
ACAAGACAGCGGGATTCAT -> CAAGACAGCGGGATTCATG
AAATTGTGCTCCGTATTCA -> AATTGTGCTCCGTATTCAA
AGTCCGGTGTGGTGCCTGG -> GTCCGGTGTGGTGCCTGGT
AAGTACTGAGCTATTTGAT -> AGTACTGAGCTATTTGATT
CGTAGCATCCCTACTCGCC -> GTAGCATCCCTACTCGCCA
GCAGCTTCTCGCCGGAAGC -> CAGCTTCTCGCCGGAAGCT
CCATCTCGTCCGGAACCTT -> CATCTCGTCCGGAACCTTG
GGCCATTCAGCCTGGGTGC -> GCCATTCAGCCTGGGTGCC
TAGGAGAATGTGAGCTAAC -> AGGAGAATGTGAGCTAACG
GAGGCTAAGCGCGAATGGC -> AGGCTAAGCGCGAATGGCT
TGAGGCTAAGCGCGAATGG -> GAGGCTAAGCGCGAATGGC
TTATTTTTCAGGATACCCT -> TATTTTTCAGGATACCCTA
TATCCGGCACTAGGCGTCA -> ATCCGGCACTAGGCGTCAA
GCACCGCAGCCGTTCAAAA -> CACCGCAGCCGTTCAAAAC
AAGCCCGGCTTTGAACGCA -> AGCCCGGCTTTGAACGCAA
TCGGTGTATAGGGATGTGG -> CGGTGTATAGGGATGTGGC
CATCCGTTTGTTGGAGAGT -> ATCCGTTTGTTGGAGAGTG
AAGTGTGTCCGAGCCACTC -> AGTGTGTCCGAGCCACTCA
GGCGTGTAACGTCTGATCT -> GCGTGTAACGTCTGATCTC
CTAACGAGGTGTACTTCTA -> TAACGAGGTGTACTTCTAC
AGTCTCAATAAAGTACTGA -> GTCTCAATAAAGTACTGAG
CTTCGCCAGCTCCCGCTTA -> TTCGCCAGCTCCCGCTTAT
CGCGTAGACGATCGAACAC -> GCGTAGACGATCGAACACT
TGTAGACCGTTATTTTTCA -> GTAGACCGTTATTTTTCAG
TCGCCGGAAGCTAACCGTC -> CGCCGGAAGCTAACCGTCC
AGTGGTAGGTTGATCCATC -> GTGGTAGGTTGATCCATCT
ATCCTATACGTCATCCGTT -> TCCTATACGTCATCCGTTT
TTAGATGAAGTAAATTGAG -> TAGATGAAGTAAATTGAGA
GCCGGCCGGAAGCGCAGTC -> CCGGCCGGAAGCGCAGTCG
CGTCCTTTCAGATCAGGAT -> GTCCTTTCAGATCAGGATC
GCGCTCTACACCGCGTAGA -> CGCTCTACACCGCGTAGAC
TTTAACGACTTGCTGTGGC -> TTAACGACTTGCTGTGGCA
GACTTGCTGTGGCATTTGT -> ACTTGCTGTGGCATTTGTA
CGAAGGGACCGAGCAGAAT -> GAAGGGACCGAGCAGAATG
GAATCACACACAAGGAGCT -> AATCACACACAAGGAGCTG
ATGTGGTCCCGTGCGTCCT -> TGTGGTCCCGTGCGTCCTT
ACAAGTTTCACTCTTCTTC -> CAAGTTTCACTCTTCTTCA
CACTCCTTTAACTCACGAG -> ACTCCTTTAACTCACGAGT
GTAGGACTACCTGGAGCAG -> TAGGACTACCTGGAGCAGC
GGCTTGTTTGGCACGCCGC -> GCTTGTTTGGCACGCCGCC
GTGGTCCCGTGCGTCCTTT -> TGGTCCCGTGCGTCCTTTC
AGGGTTCCAATAGGATATC -> GGGTTCCAATAGGATATCC
TACCCATGTAAGACGTGTG -> ACCCATGTAAGACGTGTGG
TAACTAACGAGGTGTACTT -> AACTAACGAGGTGTACTTC
GGACCTGTAGGATGTCCCT -> GACCTGTAGGATGTCCCTT
ATCAGGATCAGCTACTCTT -> TCAGGATCAGCTACTCTTG
TCGAGTAGATGGTTGCCTT -> CGAGTAGATGGTTGCCTTA
CAACGAAGGGACCGAGCAG -> AACGAAGGGACCGAGCAGA
TACGTACCGGCTCTTTCGG -> ACGTACCGGCTCTTTCGGG
GAAGAACTGATCTTCGCTC -> AAGAACTGATCTTCGCTCC
CAAAGTCCCCACTTGCTTC -> AAAGTCCCCACTTGCTTCG
CCGTTCGGTGTATAGGGAT -> CGTTCGGTGTATAGGGATG
GTCATGCCGGTCCCTTCAA -> TCATGCCGGTCCCTTCAAG
GAGTGACAAACACAGCTCC -> AGTGACAAACACAGCTCCA
GCGCAGAGCAAGTGAGTCT -> CGCAGAGCAAGTGAGTCTC
ACCACGTTCCTGACAAGGA -> CCACGTTCCTGACAAGGAT
GTATCGTACCTCCGGACTA -> TATCGTACCTCCGGACTAA
GCTTGTACCATAGTCAGTA -> CTTGTACCATAGTCAGTAC
CATTCAGCCTGGGTGCCCA -> ATTCAGCCTGGGTGCCCAT
TGCCCAATACGATGCTGTG -> GCCCAATACGATGCTGTGA
GCTCTATTTGCCTTTCATT -> CTCTATTTGCCTTTCATTT
TTTTCAGGATACCCTACTT -> TTTCAGGATACCCTACTTT
CTTGAGCCTTGCGCTCTAC -> TTGAGCCTTGCGCTCTACA
TCCGGATTCATGTCATGCC -> CCGGATTCATGTCATGCCG
CGTCAACTCACTCGTTCGA -> GTCAACTCACTCGTTCGAG
AGCCGTACGCTTAGATAGA -> GCCGTACGCTTAGATAGAG
TATTTGCCTTTCATTTTCC -> ATTTGCCTTTCATTTTCCG
GCTATCTCCGACAAGACAG -> CTATCTCCGACAAGACAGC
TCCCGGAGCCTGGACAGTT -> CCCGGAGCCTGGACAGTTT
TCGCGGGGGCTACCGTTCG -> CGCGGGGGCTACCGTTCGG
GGGTCGCGGGGGCTACCGC -> GGTCGCGGGGGCTACCGCC
ATCAGCATAGTAGTTAGAC -> TCAGCATAGTAGTTAGACG
CTCGCCAACACAAGTTGCG -> TCGCCAACACAAGTTGCGG
ACTCGCAACTAAATACCTG -> CTCGCAACTAAATACCTGG
CTTAGCAAGGGTTCCAATA -> TTAGCAAGGGTTCCAATAG
GCATCCCTACTCGCCAACA -> CATCCCTACTCGCCAACAC
ACATGGGTGCGAGTCCGGT -> CATGGGTGCGAGTCCGGTG
CGATATCCGGCACTAGGCG -> GATATCCGGCACTAGGCGT
TTATAGCTGCTAAGAAGTA -> TATAGCTGCTAAGAAGTAT
CCTCGGTGGTTTTGGGAGC -> CTCGGTGGTTTTGGGAGCG
GCTCCGTATTCAAGTGTGT -> CTCCGTATTCAAGTGTGTC
GTACGCTTAGATAGAGATA -> TACGCTTAGATAGAGATAT
AGGATACCCTACTTTCATG -> GGATACCCTACTTTCATGG
GACGATCGAACACTCCTTT -> ACGATCGAACACTCCTTTA
CCGCTCCTTCTAAGTTTCT -> CGCTCCTTCTAAGTTTCTG
CTTCTAAGTTTCTGGCCGA -> TTCTAAGTTTCTGGCCGAT
CCAAGAATCTACTCGAACA -> CAAGAATCTACTCGAACAA
GCGTGTAACGTCTGATCTC -> CGTGTAACGTCTGATCTCC
GGCAGTCATAAGGTTCGAC -> GCAGTCATAAGGTTCGACA
ATGGAATCACACACAAGGA -> TGGAATCACACACAAGGAG
TACCTGGAGCAGCTTCTCG -> ACCTGGAGCAGCTTCTCGC
CGAGGTGTACTTCTACGGA -> GAGGTGTACTTCTACGGAA
CAGCCCGGCTGGAGGATAA -> AGCCCGGCTGGAGGATAAC
CGATCCGTAGCATCCCTAC -> GATCCGTAGCATCCCTACT
GCAAATTGTGCTCCGTATT -> CAAATTGTGCTCCGTATTC
GGAACCAGCTCCCGCTTAT -> GAACCAGCTCCCGCTTATA
GACGAGGTCACCACGTTCC -> ACGAGGTCACCACGTTCCT
TGACAAACACAGCTCCAGC -> GACAAACACAGCTCCAGCT
TCTGAGTCTAGCCGTACGC -> CTGAGTCTAGCCGTACGCT
CCCAGCTCCCGCTTATACG -> CCAGCTCCCGCTTATACGC
AGCTACGCCCTGAGCGTTT -> GCTACGCCCTGAGCGTTTC
CGGTCGGGTCGCGGGGGCT -> GGTCGGGTCGCGGGGGCTA
TATGTGATTACCCAAGAAT -> ATGTGATTACCCAAGAATC
ATTTGCCTTTCATTTTCCG -> TTTGCCTTTCATTTTCCGT
GACGTGTGGGACCTGTAGG -> ACGTGTGGGACCTGTAGGA
CCGCAGCCGTTCAAAACGG -> CGCAGCCGTTCAAAACGGT
CTACTCTTGAGCCTTGCGC -> TACTCTTGAGCCTTGCGCT
TACTCGAACAAACGATCAG -> ACTCGAACAAACGATCAGC
GGGCTTTGGAGCCTGACAT -> GGCTTTGGAGCCTGACATC
CTTCGAGTAGATGGTTGCC -> TTCGAGTAGATGGTTGCCT
TCCTATACGTCATCCGTTT -> CCTATACGTCATCCGTTTG
ACAAGGAGCTGTCGACTAG -> CAAGGAGCTGTCGACTAGG
GGTAATGGCGGTGCGTTGG -> GTAATGGCGGTGCGTTGGG
TATAGGGATGTGGCAAATT -> ATAGGGATGTGGCAAATTG
AATGGCGGTGCGTTGGGGC -> ATGGCGGTGCGTTGGGGCT
CCCTAGTTAGGATAAGAAG -> CCTAGTTAGGATAAGAAGG
CTTAAGGCTTGTTTGGCAC -> TTAAGGCTTGTTTGGCACG
GCCTTAGCAGCCGGCCGGA -> CCTTAGCAGCCGGCCGGAA
TAAGACGTGTGGGACCTGT -> AAGACGTGTGGGACCTGTA
GCCGCCATTATCGGTGGCG -> CCGCCATTATCGGTGGCGA
GGTTCCAATAGGATATCCC -> GTTCCAATAGGATATCCCT
GTCCGGTGTGGTGCCTGGT -> TCCGGTGTGGTGCCTGGTC
CCCAAGAATCTACTCGAAC -> CCAAGAATCTACTCGAACA
AGTCTGCTCAGAGCCCTAA -> GTCTGCTCAGAGCCCTAAG
GCTAGTCTTTAACGACTTG -> CTAGTCTTTAACGACTTGC
TCCGACAAGACAGCGGGAT -> CCGACAAGACAGCGGGATT
ATGTGAGCTAACGGTACAT -> TGTGAGCTAACGGTACATG
ATTTGTAGACCGTTATTTT -> TTTGTAGACCGTTATTTTT
AGACGCTTAGCAAGGGTTC -> GACGCTTAGCAAGGGTTCC
CGCTCCTTCTAAGTTTCTG -> GCTCCTTCTAAGTTTCTGG
AGTCGTTGCCCAATACGAT -> GTCGTTGCCCAATACGATG
CAAGGAGCTGTCGACTAGG -> AAGGAGCTGTCGACTAGGA
AACTGATCTTCGCTCCCTG -> ACTGATCTTCGCTCCCTGC
ACAGTTTGGACTACCAAAA -> CAGTTTGGACTACCAAAAG
CGACAAGACAGCGGGATTC -> GACAAGACAGCGGGATTCA
TCCCCACTTGCTTCGAGTA -> CCCCACTTGCTTCGAGTAG
CGCCATTATCGGTGGCGAG -> GCCATTATCGGTGGCGAGG
TGTACCATAGTCAGTACAG -> GTACCATAGTCAGTACAGG
TGCCCATATCTGAGTCTAG -> GCCCATATCTGAGTCTAGC
GGGTCGCGGGGGCTACCAC -> GGTCGCGGGGGCTACCACG
TCAAAGCGTCCGAAACAGC -> CAAAGCGTCCGAAACAGCT
TCTACACCGCGTAGACGAT -> CTACACCGCGTAGACGATC
ATGACACAGGTCGGTGGAT -> TGACACAGGTCGGTGGATA
ACAACGAAGGGACCGAGCA -> CAACGAAGGGACCGAGCAG
TCGCGGGGGCTACCCATGT -> CGCGGGGGCTACCCATGTA
GCTGAAGTACTGTTCTCGT -> CTGAAGTACTGTTCTCGTT
CAATAAAGTACTGAGCTAT -> AATAAAGTACTGAGCTATT
ATTTGATTTACTCTCTTTG -> TTTGATTTACTCTCTTTGC
CGCAGTCGTTGCCCAATAC -> GCAGTCGTTGCCCAATACG
ACCTGGAGCAGCTTCTCGC -> CCTGGAGCAGCTTCTCGCC
GCGCGAATGGCTATGTGAT -> CGCGAATGGCTATGTGATT
ATCCGTTTGTTGGAGAGTG -> TCCGTTTGTTGGAGAGTGG
CATTTGTAGACCGTTATTT -> ATTTGTAGACCGTTATTTT
CATCACTTCACTTAAAACT -> ATCACTTCACTTAAAACTC
AGCTTCGCCAGCTCCCGCT -> GCTTCGCCAGCTCCCGCTT
GATTGTTTACCGTTCACAC -> ATTGTTTACCGTTCACACC
CCAGCTCCCGCTTATACGG -> CAGCTCCCGCTTATACGGT
TACTTCTACGGAACCAGCT -> ACTTCTACGGAACCAGCTC
TTGTTGGAGAGTGGTAGGT -> TGTTGGAGAGTGGTAGGTT
GAATGACGGCTTAAGGCTT -> AATGACGGCTTAAGGCTTG
AGTGACAAACACAGCTCCA -> GTGACAAACACAGCTCCAG
TTGCCACGAGTTAGGTACG -> TGCCACGAGTTAGGTACGC
AGCGGGATTCATGCAAGTC -> GCGGGATTCATGCAAGTCC
TGGTTGCCTTAGCAGCCGG -> GGTTGCCTTAGCAGCCGGC
CCGTCGCATATCGGGTCGC -> CGTCGCATATCGGGTCGCG
GGCTATGTGATTACCCAAG -> GCTATGTGATTACCCAAGA
CGATCGCTCAAAGCGTCCG -> GATCGCTCAAAGCGTCCGA
TCCATAAGAGACGAGGTCA -> CCATAAGAGACGAGGTCAC
TGTCCGAGCCACTCATAGC -> GTCCGAGCCACTCATAGCG
GGCTACCGTTCGGTGTATA -> GCTACCGTTCGGTGTATAG
ATCTGAGTCTAGCCGTACG -> TCTGAGTCTAGCCGTACGC
TAAAACTCGCAACTAAATA -> AAAACTCGCAACTAAATAC
CCCTACTTTCATGGAATCA -> CCTACTTTCATGGAATCAC
ATTACAGCGACCGGTAATG -> TTACAGCGACCGGTAATGG
GTGGATGTCCAAGCTTCGC -> TGGATGTCCAAGCTTCGCC
ACCATAGTCAGTACAGGAC -> CCATAGTCAGTACAGGACC
GTGTGGTGCCTGGTCGTGA -> TGTGGTGCCTGGTCGTGAA
CGAGACGCCTGGGCGTTGA -> GAGACGCCTGGGCGTTGAG
TGGAGCCTGACATCGCCTA -> GGAGCCTGACATCGCCTAT
TCATTTTCCGTCCCGGCCA -> CATTTTCCGTCCCGGCCAA
ACGAGTTAGGTACGCGCCG -> CGAGTTAGGTACGCGCCGC
CGGGATTCATGCAAGTCCC -> GGGATTCATGCAAGTCCCT
ATCGTACCTCCGGACTAAC -> TCGTACCTCCGGACTAACT
GCTCCCGCTTATACGTACC -> CTCCCGCTTATACGTACCG
AGGACTTGACGATCGCTAA -> GGACTTGACGATCGCTAAG
GCAACTAAATACCTGGGGA -> CAACTAAATACCTGGGGAG
TGATCTTCGCTCCCTGCTG -> GATCTTCGCTCCCTGCTGA
CGCAGAGCAAGTGAGTCTC -> GCAGAGCAAGTGAGTCTCA
CTCGTTATGACACAGGTCG -> TCGTTATGACACAGGTCGG
GCCCGCTCCTTCTAAGTTT -> CCCGCTCCTTCTAAGTTTC
TCCAATAGGATATCCCTCA -> CCAATAGGATATCCCTCAT
TTGATTTACTCTCTTTGCC -> TGATTTACTCTCTTTGCCG
GCCGATCAGCACACCGTCA -> CCGATCAGCACACCGTCAG
ACATTTATAGCTGCTAAGA -> CATTTATAGCTGCTAAGAA
TCGCTCCCTGCTGAAGTAC -> CGCTCCCTGCTGAAGTACT
AGGCTAAGCGCGAATGGCT -> GGCTAAGCGCGAATGGCTA
ACGCGCCGCACTAGGAGAA -> CGCGCCGCACTAGGAGAAT
AGGCGTCAACTCACTCGTT -> GGCGTCAACTCACTCGTTC
GGCGTCAACTCACTCGTTC -> GCGTCAACTCACTCGTTCG
CATAGCGGGCCATTCAGCC -> ATAGCGGGCCATTCAGCCT
AGTTTGGACTACCAAAAGA -> GTTTGGACTACCAAAAGAC
CGGGGGCTACCACGATATC -> GGGGGCTACCACGATATCC
ATTCAGCCTGGGTGCCCAT -> TTCAGCCTGGGTGCCCATA
CAACTAAATACCTGGGGAG -> AACTAAATACCTGGGGAGT
CTAGGCGTCAACTCACTCG -> TAGGCGTCAACTCACTCGT
CCCTCATAATCCCGGAGCC -> CCTCATAATCCCGGAGCCT
GTACCCCCAGCTCCCGCTT -> TACCCCCAGCTCCCGCTTA
GTGCTCCGTATTCAAGTGT -> TGCTCCGTATTCAAGTGTG
TTATACGACCGTCGCATAT -> TATACGACCGTCGCATATC
TACCTGGGGAGTGACAAAC -> ACCTGGGGAGTGACAAACA
CACCACGTTCCTGACAAGG -> ACCACGTTCCTGACAAGGA
TTCATGTCATGCCGGTCCC -> TCATGTCATGCCGGTCCCT
CCGTGCGTCCTTTCAGATC -> CGTGCGTCCTTTCAGATCA
CTACCACGATATCCGGCAC -> TACCACGATATCCGGCACT
AGCTCCAGCTCCCGCTTAT -> GCTCCAGCTCCCGCTTATA
GGAGAATGCGTTAGGCTTT -> GAGAATGCGTTAGGCTTTT
TGTGAGCTAACGGTACATG -> GTGAGCTAACGGTACATGG
AATACGATGCTGTGACAGC -> ATACGATGCTGTGACAGCG
AGCGAGCCTCCTCGGTGGT -> GCGAGCCTCCTCGGTGGTT
ACGGTACATGGGTGCGAGT -> CGGTACATGGGTGCGAGTC
TTGAGAGTCTGCTCAGAGC -> TGAGAGTCTGCTCAGAGCC
CGACTTAAGCCCGTACCCC -> GACTTAAGCCCGTACCCCC
TTTACTCTCTTTGCCGACG -> TTACTCTCTTTGCCGACGA
TACCCAAGAATCTACTCGA -> ACCCAAGAATCTACTCGAA
AACCAGGCGTCCATTGCCA -> ACCAGGCGTCCATTGCCAC
ATTCATGCAAGTCCCTAGT -> TTCATGCAAGTCCCTAGTT
ATCTCGTCCGGAACCTTGC -> TCTCGTCCGGAACCTTGCT
ATGGTTGCCTTAGCAGCCG -> TGGTTGCCTTAGCAGCCGG
CATGCAAGTCCCTAGTTAG -> ATGCAAGTCCCTAGTTAGG
CTTTGCCGACGACAGGTGC -> TTTGCCGACGACAGGTGCT
ACCTGTAGGATGTCCCTTG -> CCTGTAGGATGTCCCTTGC
TCTGGCCGATCAGCACACC -> CTGGCCGATCAGCACACCG
ACCAAGCTCTATTTGCCTT -> CCAAGCTCTATTTGCCTTT
GGCTGGAGGATAACCCACT -> GCTGGAGGATAACCCACTG
GTCGTTGCCCAATACGATG -> TCGTTGCCCAATACGATGC
GCGAGTCCGGTGTGGTGCC -> CGAGTCCGGTGTGGTGCCT
CAGTACAGGACCTGGGCTT -> AGTACAGGACCTGGGCTTT
GCTATTTGATTTACTCTCT -> CTATTTGATTTACTCTCTT
TGACAACGAAGGGACCGAG -> GACAACGAAGGGACCGAGC
CGCCGCACTAGGAGAATGC -> GCCGCACTAGGAGAATGCG
CATGTAAGACGTGTGGGAC -> ATGTAAGACGTGTGGGACC
GGTACATGGGTGCGAGTCC -> GTACATGGGTGCGAGTCCG
CAGCGGGATTCATGCAAGT -> AGCGGGATTCATGCAAGTC
ATATGTGGTCCCGTGCGTC -> TATGTGGTCCCGTGCGTCC
TGACGATCGCTCAAAGCGT -> GACGATCGCTCAAAGCGTC
TGGGCTTTGGAGCCTGACA -> GGGCTTTGGAGCCTGACAT
ACGTCATCCGTTTGTTGGA -> CGTCATCCGTTTGTTGGAG
ACTAGGAGAATGCGTTAGG -> CTAGGAGAATGCGTTAGGC
GGACTACCAAAAGACAAGT -> GACTACCAAAAGACAAGTT
TAAGTTTCTGGCCGATCAG -> AAGTTTCTGGCCGATCAGC
GTTTCAAGTTTCGACTTAA -> TTTCAAGTTTCGACTTAAG
CGTCCATTGCCACGAGTTA -> GTCCATTGCCACGAGTTAG
CTTGCGAGACGCCTGGGCG -> TTGCGAGACGCCTGGGCGT
AGGATTACAGCGACCGGTA -> GGATTACAGCGACCGGTAA
CAAACGGGGTCAGCAGGCG -> AAACGGGGTCAGCAGGCGG
GGATAAGAAGGACTTGACG -> GATAAGAAGGACTTGACGA
CGAACACTCCTTTAACTCA -> GAACACTCCTTTAACTCAC
CGGAAGCGCAGTCGTTGCC -> GGAAGCGCAGTCGTTGCCC
CACACCTGAGATGCCAAAC -> ACACCTGAGATGCCAAACA
GGTGCTTGTACCATAGTCA -> GTGCTTGTACCATAGTCAG
TGCTTCGAGTAGATGGTTG -> GCTTCGAGTAGATGGTTGC
TTACAGCGACCGGTAATGG -> TACAGCGACCGGTAATGGC
TTGAGTGGATGTCCAAGCT -> TGAGTGGATGTCCAAGCTT
TCGAGATATGCACTGGGCG -> CGAGATATGCACTGGGCGT
ATTAGATGAAGTAAATTGA -> TTAGATGAAGTAAATTGAG
AATGACGGCTTAAGGCTTG -> ATGACGGCTTAAGGCTTGT
GCGAATGGCTATGTGATTA -> CGAATGGCTATGTGATTAC
AGAAATCAGGTAACCCGAT -> GAAATCAGGTAACCCGATT
GGAAGGCTTTATGACAACG -> GAAGGCTTTATGACAACGA
TGTAGGACTACCTGGAGCA -> GTAGGACTACCTGGAGCAG
CCGTCAGCCCGGCTGGAGG -> CGTCAGCCCGGCTGGAGGA
CCTGCTGAAGTACTGTTCT -> CTGCTGAAGTACTGTTCTC
AGCAGCTTCTCGCCGGAAG -> GCAGCTTCTCGCCGGAAGC
TGATCCATCTCGTCCGGAA -> GATCCATCTCGTCCGGAAC
GCGAGACGCCTGGGCGTTG -> CGAGACGCCTGGGCGTTGA
CTACCCATGTAAGACGTGT -> TACCCATGTAAGACGTGTG
GTTTCCAACATTTATAGCT -> TTTCCAACATTTATAGCTG
TTGGAGAGTGGTAGGTTGA -> TGGAGAGTGGTAGGTTGAT
GCTTTATGACAACGAAGGG -> CTTTATGACAACGAAGGGA
CCCTGCTGAAGTACTGTTC -> CCTGCTGAAGTACTGTTCT
GTTGGAGAGTGGTAGGTTG -> TTGGAGAGTGGTAGGTTGA
TAGGTACGCGCCGCACTAG -> AGGTACGCGCCGCACTAGG
TAGTTAGGATAAGAAGGAC -> AGTTAGGATAAGAAGGACT
CGTGTAACGTCTGATCTCC -> GTGTAACGTCTGATCTCCA
CCCTACTCGCCAACACAAG -> CCTACTCGCCAACACAAGT
TCGTACCTCCGGACTAACT -> CGTACCTCCGGACTAACTA
CCGATTGTTTACCGTTCAC -> CGATTGTTTACCGTTCACA
CCTCATAATCCCGGAGCCT -> CTCATAATCCCGGAGCCTG
CTGGGCGTGTAACGTCTGA -> TGGGCGTGTAACGTCTGAT
GGAGAGTAAGGATTACAGC -> GAGAGTAAGGATTACAGCG
GGCTTTGGAGCCTGACATC -> GCTTTGGAGCCTGACATCG
TGAGTCTCAATAAAGTACT -> GAGTCTCAATAAAGTACTG
AGCATCCCTACTCGCCAAC -> GCATCCCTACTCGCCAACA
CGCTACTCTGTAGGACTAC -> GCTACTCTGTAGGACTACC
CAGCTCCCGCTTATACGCT -> AGCTCCCGCTTATACGCTT
AGCCCGGCTTTGAACGCAA -> GCCCGGCTTTGAACGCAAT
GGATAACCCACTGAAGAAC -> GATAACCCACTGAAGAACT
CGGTGGATACGAATAGTTT -> GGTGGATACGAATAGTTTC
ACGTTCCTGACAAGGATAA -> CGTTCCTGACAAGGATAAG
ATTATCGGTGGCGAGGGGA -> TTATCGGTGGCGAGGGGAG
CGTTATTTTTCAGGATACC -> GTTATTTTTCAGGATACCC
ATACGGTCCTGGCCGGTCG -> TACGGTCCTGGCCGGTCGG
TCGCGCAGAGCAAGTGAGT -> CGCGCAGAGCAAGTGAGTC
GATCAGCTACTCTTGAGCC -> ATCAGCTACTCTTGAGCCT
CTGAGCGTTTCGCGCAGAG -> TGAGCGTTTCGCGCAGAGC
AAGAACTGATCTTCGCTCC -> AGAACTGATCTTCGCTCCC
CTGACATCGCCTATAATCG -> TGACATCGCCTATAATCGG
ATAGGATATCCCTCATAAT -> TAGGATATCCCTCATAATC
GTTTGTTGGAGAGTGGTAG -> TTTGTTGGAGAGTGGTAGG
TTCTCGTTATGACACAGGT -> TCTCGTTATGACACAGGTC
GCGCCGCACTAGGAGAATG -> CGCCGCACTAGGAGAATGC
CGGCCGGAAGCGCAGTCGT -> GGCCGGAAGCGCAGTCGTT
GGGTCGCGGGGGCTACCGT -> GGTCGCGGGGGCTACCGTT
ACGGGGTCAGCAGGCGGCA -> CGGGGTCAGCAGGCGGCAG
GACAGGTGCTTGTACCATA -> ACAGGTGCTTGTACCATAG
TCGACAGAGAGAGACAGAA -> CGACAGAGAGAGACAGAAA
GTGTATAGGGATGTGGCAA -> TGTATAGGGATGTGGCAAA
CACAAGGAGCTGTCGACTA -> ACAAGGAGCTGTCGACTAG
TCCGGTGTGGTGCCTGGTC -> CCGGTGTGGTGCCTGGTCG
ACCTCCGGACTAACTAACG -> CCTCCGGACTAACTAACGA
CTAACTAACGAGGTGTACT -> TAACTAACGAGGTGTACTT
AGCTCCCGCTTATACGCTT -> GCTCCCGCTTATACGCTTG
TTGTTATCAGTCGGGTCGC -> TGTTATCAGTCGGGTCGCG
GGGGCTACCCATGTAAGAC -> GGGCTACCCATGTAAGACG
CGGTGTATAGGGATGTGGC -> GGTGTATAGGGATGTGGCA
ATCTCCATCACTTCACTTA -> TCTCCATCACTTCACTTAA
CCTGGGGAGTGACAAACAC -> CTGGGGAGTGACAAACACA
CTATTTGCCTTTCATTTTC -> TATTTGCCTTTCATTTTCC
CTCGCCGGAAGCTAACCGT -> TCGCCGGAAGCTAACCGTC
ACGACAGGTGCTTGTACCA -> CGACAGGTGCTTGTACCAT
TGGGCGTTGAGTGGATGTC -> GGGCGTTGAGTGGATGTCC
CCCGGCTTTGAACGCAATG -> CCGGCTTTGAACGCAATGA
ACGCTTAGATAGAGATATG -> CGCTTAGATAGAGATATGT
CAGGTAACCCGATTGTTTA -> AGGTAACCCGATTGTTTAC
AGCCTGGGTGCCCATATCT -> GCCTGGGTGCCCATATCTG
TGGCCGATCAGCACACCGT -> GGCCGATCAGCACACCGTC
GTAACGTCTGATCTCCATC -> TAACGTCTGATCTCCATCA
AGTACTGAGCTATTTGATT -> GTACTGAGCTATTTGATTT
TCTAAGTTTCTGGCCGATC -> CTAAGTTTCTGGCCGATCA
TAAGGTTCGACAGAGAGAG -> AAGGTTCGACAGAGAGAGA
ACTAACTAACGAGGTGTAC -> CTAACTAACGAGGTGTACT
TCAGCAGGCGGCAGTCGAA -> CAGCAGGCGGCAGTCGAAA
TGCCTTTCATTTTCCGTCC -> GCCTTTCATTTTCCGTCCC
TTTCGCGCAGAGCAAGTGA -> TTCGCGCAGAGCAAGTGAG
TTCTACGGAACCAGCTCCC -> TCTACGGAACCAGCTCCCG
GAGGATAACCCACTGAAGA -> AGGATAACCCACTGAAGAA
TCTGTAGGACTACCTGGAG -> CTGTAGGACTACCTGGAGC
CAAGTTGCGGTGAGGAAGG -> AAGTTGCGGTGAGGAAGGC
GGGCGTGTAACGTCTGATC -> GGCGTGTAACGTCTGATCT
TCAAGCACAGCTAGTCTTT -> CAAGCACAGCTAGTCTTTA
TGGCCGGTCGGGTCGCGGG -> GGCCGGTCGGGTCGCGGGG
GGGGCTACCACGATATCCG -> GGGCTACCACGATATCCGG
GCCCAATACGATGCTGTGA -> CCCAATACGATGCTGTGAC
CCCAATACGATGCTGTGAC -> CCAATACGATGCTGTGACA
AGCCGGCCGGAAGCGCAGT -> GCCGGCCGGAAGCGCAGTC
TTATACGTACCGGCTCTTT -> TATACGTACCGGCTCTTTC
TGCCGACGACAGGTGCTTG -> GCCGACGACAGGTGCTTGT
GTGGCATTTGTAGACCGTT -> TGGCATTTGTAGACCGTTA
GTACATGGGTGCGAGTCCG -> TACATGGGTGCGAGTCCGG
ACTTAAGCCCGTACCCCCA -> CTTAAGCCCGTACCCCCAG
GATACGAATAGTTTCCAAC -> ATACGAATAGTTTCCAACA
CACACAAGGAGCTGTCGAC -> ACACAAGGAGCTGTCGACT
TCATGGAATCACACACAAG -> CATGGAATCACACACAAGG
GAAATCAGGTAACCCGATT -> AAATCAGGTAACCCGATTG
ATCTTCGCTCCCTGCTGAA -> TCTTCGCTCCCTGCTGAAG
GTCTGCTCAGAGCCCTAAG -> TCTGCTCAGAGCCCTAAGG
GAGCGTTTCGCGCAGAGCA -> AGCGTTTCGCGCAGAGCAA
GAGCTAACGGTACATGGGT -> AGCTAACGGTACATGGGTG
AACTAAATACCTGGGGAGT -> ACTAAATACCTGGGGAGTG
TGAAGTAAATTGAGAGTCT -> GAAGTAAATTGAGAGTCTG
TGTTCTCGTTATGACACAG -> GTTCTCGTTATGACACAGG
GTCAACTCACTCGTTCGAG -> TCAACTCACTCGTTCGAGA
TGAGCGTTTCGCGCAGAGC -> GAGCGTTTCGCGCAGAGCA
GGGGCTACCGCCGCTACTC -> GGGCTACCGCCGCTACTCT
CGCTTAGATAGAGATATGT -> GCTTAGATAGAGATATGTG
TTGCGCTCTACACCGCGTA -> TGCGCTCTACACCGCGTAG
GCTAGCTACGCCCTGAGCG -> CTAGCTACGCCCTGAGCGT
ATTCATGTCATGCCGGTCC -> TTCATGTCATGCCGGTCCC
GAGAGACAGAAATCAGGTA -> AGAGACAGAAATCAGGTAA
GTACTTCTACGGAACCAGC -> TACTTCTACGGAACCAGCT
GCCTCCTCGGTGGTTTTGG -> CCTCCTCGGTGGTTTTGGG
CGCCAACACAAGTTGCGGT -> GCCAACACAAGTTGCGGTG
GACTAGGAGAATGTGAGCT -> ACTAGGAGAATGTGAGCTA
TAGCTACGCCCTGAGCGTT -> AGCTACGCCCTGAGCGTTT
GCCAACACAAGTTGCGGTG -> CCAACACAAGTTGCGGTGA
GCCGGAAGCTAACCGTCCG -> CCGGAAGCTAACCGTCCGG
CACTCATAGCGGGCCATTC -> ACTCATAGCGGGCCATTCA
GATGTGGCAAATTGTGCTC -> ATGTGGCAAATTGTGCTCC
ATCACTTCACTTAAAACTC -> TCACTTCACTTAAAACTCG
TAGCAAGGGTTCCAATAGG -> AGCAAGGGTTCCAATAGGA
CAGTCGTTGCCCAATACGA -> AGTCGTTGCCCAATACGAT
AGCCACTCATAGCGGGCCA -> GCCACTCATAGCGGGCCAT
GTGACAGCGAGCCTCCTCG -> TGACAGCGAGCCTCCTCGG
CCTTTCATTTTCCGTCCCG -> CTTTCATTTTCCGTCCCGG
TTAGGCTTTTTGCACCGCA -> TAGGCTTTTTGCACCGCAG
CGATTGTTTACCGTTCACA -> GATTGTTTACCGTTCACAC
GTCCGAGCCACTCATAGCG -> TCCGAGCCACTCATAGCGG
TGTCATGCCGGTCCCTTCA -> GTCATGCCGGTCCCTTCAA
AGGATCAGCTACTCTTGAG -> GGATCAGCTACTCTTGAGC
TCCCGTGCGTCCTTTCAGA -> CCCGTGCGTCCTTTCAGAT
ACCGTCGCATATCGGGTCG -> CCGTCGCATATCGGGTCGC
CGCTTATACGTACCGGCTC -> GCTTATACGTACCGGCTCT
CCCGTGCGTCCTTTCAGAT -> CCGTGCGTCCTTTCAGATC
TTTCATGGAATCACACACA -> TTCATGGAATCACACACAA
ACAGAGAGAGACAGAAATC -> CAGAGAGAGACAGAAATCA
GATATGCACTGGGCGTGTA -> ATATGCACTGGGCGTGTAA
CCGGAACCTTGCTTCGTTA -> CGGAACCTTGCTTCGTTAC
GATTTACTCTCTTTGCCGA -> ATTTACTCTCTTTGCCGAC
GAGTGGTAGGTTGATCCAT -> AGTGGTAGGTTGATCCATC
GGGCGTTGAGTGGATGTCC -> GGCGTTGAGTGGATGTCCA
CCACGTTCCTGACAAGGAT -> CACGTTCCTGACAAGGATA
CACTGGGCGTGTAACGTCT -> ACTGGGCGTGTAACGTCTG
TCCCGCTTATACGACCGTC -> CCCGCTTATACGACCGTCG
CTCTTGAGCCTTGCGCTCT -> TCTTGAGCCTTGCGCTCTA
GATCTCCATCACTTCACTT -> ATCTCCATCACTTCACTTA
AGGTGCTTGTACCATAGTC -> GGTGCTTGTACCATAGTCA
TGCGCTCTACACCGCGTAG -> GCGCTCTACACCGCGTAGA
TAACGACTTGCTGTGGCAT -> AACGACTTGCTGTGGCATT
CGGAAGCTAACCGTCCGGA -> GGAAGCTAACCGTCCGGAT
CTGAAGTACTGTTCTCGTT -> TGAAGTACTGTTCTCGTTA
AACCGTCCGGATTCATGTC -> ACCGTCCGGATTCATGTCA
CTGGAGGATAACCCACTGA -> TGGAGGATAACCCACTGAA
AAGTATCGTACCTCCGGAC -> AGTATCGTACCTCCGGACT
AGACCGTTATTTTTCAGGA -> GACCGTTATTTTTCAGGAT
AAGCCCGTACCCCCAGCTC -> AGCCCGTACCCCCAGCTCC
GAAACCAAGCTCTATTTGC -> AAACCAAGCTCTATTTGCC
AAACGGTTCCATAAGAGAC -> AACGGTTCCATAAGAGACG
AGTATCGTACCTCCGGACT -> GTATCGTACCTCCGGACTA
TGACATCGCCTATAATCGG -> GACATCGCCTATAATCGGC
GGCTACCACGATATCCGGC -> GCTACCACGATATCCGGCA
GAAGGGACCGAGCAGAATG -> AAGGGACCGAGCAGAATGA
GATAAGCCCGGCTTTGAAC -> ATAAGCCCGGCTTTGAACG
TTGGGGCTGAGGCTAAGCG -> TGGGGCTGAGGCTAAGCGC
GTGGATACGAATAGTTTCC -> TGGATACGAATAGTTTCCA
CAAGCTTCGCCAGCTCCCG -> AAGCTTCGCCAGCTCCCGC
AGTAGATGGTTGCCTTAGC -> GTAGATGGTTGCCTTAGCA
ACGAAGGGACCGAGCAGAA -> CGAAGGGACCGAGCAGAAT
CCTTCAAGCACAGCTAGTC -> CTTCAAGCACAGCTAGTCT
TAAGGCTTGTTTGGCACGC -> AAGGCTTGTTTGGCACGCC
CTTAAAACTCGCAACTAAA -> TTAAAACTCGCAACTAAAT
CAAGGATAAGCCCGGCTTT -> AAGGATAAGCCCGGCTTTG
CTACGGAACCAGCTCCCGC -> TACGGAACCAGCTCCCGCT
TCTTCATTACAGCAGCGAT -> CTTCATTACAGCAGCGATC
CCGGCTCTTTCGGGTCGCG -> CGGCTCTTTCGGGTCGCGG
GTTCGACAGAGAGAGACAG -> TTCGACAGAGAGAGACAGA
AAACGGGGTCAGCAGGCGG -> AACGGGGTCAGCAGGCGGC
TTTTGGGAGCGGTGACGAT -> TTTGGGAGCGGTGACGATC
ACGCCCTGAGCGTTTCGCG -> CGCCCTGAGCGTTTCGCGC
TGAGCTATTTGATTTACTC -> GAGCTATTTGATTTACTCT
TGGCATTTGTAGACCGTTA -> GGCATTTGTAGACCGTTAT
AACCTTGCTTCGTTACTCG -> ACCTTGCTTCGTTACTCGT
CATTATCGGTGGCGAGGGG -> ATTATCGGTGGCGAGGGGA
CATGGGTGCGAGTCCGGTG -> ATGGGTGCGAGTCCGGTGT
CTGGTCGTGAAACCAAGCT -> TGGTCGTGAAACCAAGCTC
GCATTTGTAGACCGTTATT -> CATTTGTAGACCGTTATTT
GAGAGAGACAGAAATCAGG -> AGAGAGACAGAAATCAGGT
AGTTAGACGCTTAGCAAGG -> GTTAGACGCTTAGCAAGGG
GAGTCTAGCCGTACGCTTA -> AGTCTAGCCGTACGCTTAG
GCTTAGATAGAGATATGTG -> CTTAGATAGAGATATGTGG
GCCCGTACCCCCAGCTCCC -> CCCGTACCCCCAGCTCCCG
GGGATTCATGCAAGTCCCT -> GGATTCATGCAAGTCCCTA
ACGAGGTCACCACGTTCCT -> CGAGGTCACCACGTTCCTG
TAGATGAAGTAAATTGAGA -> AGATGAAGTAAATTGAGAG
CTGTTCTCGTTATGACACA -> TGTTCTCGTTATGACACAG
GAGTCTCAATAAAGTACTG -> AGTCTCAATAAAGTACTGA
TCCGTCCCGGCCAAACGGG -> CCGTCCCGGCCAAACGGGG
CTGGACAGTTTGGACTACC -> TGGACAGTTTGGACTACCA
GTTACTCGTTCTGCCCGCT -> TTACTCGTTCTGCCCGCTC
TATACGTACCGGCTCTTTC -> ATACGTACCGGCTCTTTCG
TCCCTACTCGCCAACACAA -> CCCTACTCGCCAACACAAG
CGTACCTCCGGACTAACTA -> GTACCTCCGGACTAACTAA
ACAAGGATAAGCCCGGCTT -> CAAGGATAAGCCCGGCTTT
CTTGTTATCAGTCGGGTCG -> TTGTTATCAGTCGGGTCGC
TGCCTGGTCGTGAAACCAA -> GCCTGGTCGTGAAACCAAG
TCCCTCATAATCCCGGAGC -> CCCTCATAATCCCGGAGCC
AGGCTTTTTGCACCGCAGC -> GGCTTTTTGCACCGCAGCC
GGAGCGGTGACGATCGCTC -> GAGCGGTGACGATCGCTCA
CGTCCGGATTCATGTCATG -> GTCCGGATTCATGTCATGC
GCTTTTTGCACCGCAGCCG -> CTTTTTGCACCGCAGCCGT
TCAGCCTGGGTGCCCATAT -> CAGCCTGGGTGCCCATATC
TTGGGAGCGGTGACGATCG -> TGGGAGCGGTGACGATCGC
AAGGTTCGACAGAGAGAGA -> AGGTTCGACAGAGAGAGAC
CTAAGGCAGTCATAAGGTT -> TAAGGCAGTCATAAGGTTC
CACTTAAAACTCGCAACTA -> ACTTAAAACTCGCAACTAA
CACTAGGAGAATGCGTTAG -> ACTAGGAGAATGCGTTAGG
GGATGTCCCTTGCGAGACG -> GATGTCCCTTGCGAGACGC
AAACTCGCAACTAAATACC -> AACTCGCAACTAAATACCT
CTTTGAACGCAATGAGATC -> TTTGAACGCAATGAGATCC
TTGCTGTGGCATTTGTAGA -> TGCTGTGGCATTTGTAGAC
TCCGTTTGTTGGAGAGTGG -> CCGTTTGTTGGAGAGTGGT
GGTAGGTTGATCCATCTCG -> GTAGGTTGATCCATCTCGT
AGGGATGTGGCAAATTGTG -> GGGATGTGGCAAATTGTGC
CGTCCCGGCCAAACGGGGT -> GTCCCGGCCAAACGGGGTC
TGGGAGCGGTGACGATCGC -> GGGAGCGGTGACGATCGCT
CTCCATCACTTCACTTAAA -> TCCATCACTTCACTTAAAA
CTGAGATGCCAAACATTAG -> TGAGATGCCAAACATTAGA
CAGCTCCCGCTTATACGAC -> AGCTCCCGCTTATACGACC
AGTTTCGACTTAAGCCCGT -> GTTTCGACTTAAGCCCGTA
GGGGGCTACCGTTCGGTGT -> GGGGCTACCGTTCGGTGTA
GCGATCCGTAGCATCCCTA -> CGATCCGTAGCATCCCTAC
AGGTAACCCGATTGTTTAC -> GGTAACCCGATTGTTTACC
GAAAAGAATAGCCCAAAGT -> AAAAGAATAGCCCAAAGTC
GATCGCTAAGGCAGTCATA -> ATCGCTAAGGCAGTCATAA
GTCAGCCCGGCTGGAGGAT -> TCAGCCCGGCTGGAGGATA
GGCTTTTTGCACCGCAGCC -> GCTTTTTGCACCGCAGCCG
GTCCCCACTTGCTTCGAGT -> TCCCCACTTGCTTCGAGTA
ACGGCTTAAGGCTTGTTTG -> CGGCTTAAGGCTTGTTTGG
AGAATGCGTTAGGCTTTTT -> GAATGCGTTAGGCTTTTTG
AACGATCAGCATAGTAGTT -> ACGATCAGCATAGTAGTTA
TCATCCGTTTGTTGGAGAG -> CATCCGTTTGTTGGAGAGT
CCGTACGCTTAGATAGAGA -> CGTACGCTTAGATAGAGAT
CCTTTAACTCACGAGTTTC -> CTTTAACTCACGAGTTTCA
TTCAAGTGTGTCCGAGCCA -> TCAAGTGTGTCCGAGCCAC
ATACGTACCGGCTCTTTCG -> TACGTACCGGCTCTTTCGG
CGCGCCGCACTAGGAGAAT -> GCGCCGCACTAGGAGAATG
AGCCTCCTCGGTGGTTTTG -> GCCTCCTCGGTGGTTTTGG
TGACGATCGCTAAGGCAGT -> GACGATCGCTAAGGCAGTC
GGCTTAAGGCTTGTTTGGC -> GCTTAAGGCTTGTTTGGCA
CGTCAGCCCGGCTGGAGGA -> GTCAGCCCGGCTGGAGGAT
TCCCTTCAAGCACAGCTAG -> CCCTTCAAGCACAGCTAGT
AGCCCGGCTGGAGGATAAC -> GCCCGGCTGGAGGATAACC
AAACAGCTAGCTACGCCCT -> AACAGCTAGCTACGCCCTG
CGCGGGGGCTACCGCCGCT -> GCGGGGGCTACCGCCGCTA
CAACATTTATAGCTGCTAA -> AACATTTATAGCTGCTAAG
AGGCAGTCATAAGGTTCGA -> GGCAGTCATAAGGTTCGAC
ACCCAAGAATCTACTCGAA -> CCCAAGAATCTACTCGAAC
GACCTGTAGGATGTCCCTT -> ACCTGTAGGATGTCCCTTG
ATTGAGAGTCTGCTCAGAG -> TTGAGAGTCTGCTCAGAGC
TTCGCGCAGAGCAAGTGAG -> TCGCGCAGAGCAAGTGAGT
ACTGTTCTCGTTATGACAC -> CTGTTCTCGTTATGACACA
TCACTTAAAACTCGCAACT -> CACTTAAAACTCGCAACTA
AGGCTTTATGACAACGAAG -> GGCTTTATGACAACGAAGG
GCTCCCGCTTATACGACCG -> CTCCCGCTTATACGACCGT
TTAGACGCTTAGCAAGGGT -> TAGACGCTTAGCAAGGGTT
GCACTAGGAGAATGCGTTA -> CACTAGGAGAATGCGTTAG
AGAATCTACTCGAACAAAC -> GAATCTACTCGAACAAACG
CCCGCTTATACGGTCCTGG -> CCGCTTATACGGTCCTGGC
ACTCCTTTAACTCACGAGT -> CTCCTTTAACTCACGAGTT
TGCCACGAGTTAGGTACGC -> GCCACGAGTTAGGTACGCG
ACCAGCTCCCGCTTATACG -> CCAGCTCCCGCTTATACGA
GCAGCCGTTCAAAACGGTT -> CAGCCGTTCAAAACGGTTC
TCGTTCGAGATATGCACTG -> CGTTCGAGATATGCACTGG
AATCAGGTAACCCGATTGT -> ATCAGGTAACCCGATTGTT
ACGGTTCCATAAGAGACGA -> CGGTTCCATAAGAGACGAG
ACTCTTCTTCATTACAGCA -> CTCTTCTTCATTACAGCAG
CTCCCTGCTGAAGTACTGT -> TCCCTGCTGAAGTACTGTT
GTAGACGATCGAACACTCC -> TAGACGATCGAACACTCCT
AGCTCTATTTGCCTTTCAT -> GCTCTATTTGCCTTTCATT
CTCCAGCTCCCGCTTATAC -> TCCAGCTCCCGCTTATACG
TTACAGCAGCGATCCGTAG -> TACAGCAGCGATCCGTAGC
CTGGCCGGTCGGGTCGCGG -> TGGCCGGTCGGGTCGCGGG
TCGCGGGGGCTACCACGAT -> CGCGGGGGCTACCACGATA
TCAGATCAGGATCAGCTAC -> CAGATCAGGATCAGCTACT
TGCAAGTCCCTAGTTAGGA -> GCAAGTCCCTAGTTAGGAT
TTGCCGACGACAGGTGCTT -> TGCCGACGACAGGTGCTTG
TCGCTCAAAGCGTCCGAAA -> CGCTCAAAGCGTCCGAAAC
