ATACTCGCTCG -> TACTCGCTCGC
TTCACTACTCG -> TCACTACTCGT
ATGCCAGCAGG -> TGCCAGCAGGA
ATATTCCTCTG -> TATTCCTCTGT
ATGAATACACC -> TGAATACACCA
GTTAGCCTGCG -> TTAGCCTGCGC
GTACTCTTGTT -> TACTCTTGTTG
ATAGATGATCA -> TAGATGATCAG
CCTGGCCTTGA -> CTGGCCTTGAT
CTGCTTCAATA -> TGCTTCAATAG
GATCACTAAAG -> ATCACTAAAGC
AGATTAATGGG -> GATTAATGGGA
GATATCACGCG -> ATATCACGCGG
ACCAGCGTGTA -> CCAGCGTGTAA
AATATGCGATT -> ATATGCGATTA
GACAGTAGATT -> ACAGTAGATTA
GCTAGTAACAA -> CTAGTAACAAT
CATCGGATGTA -> ATCGGATGTAG
TATGTTAAAAG -> ATGTTAAAAGC
GCAGCAGTGTG -> CAGCAGTGTGA
CGGGGACTGCC -> GGGGACTGCCA
TATCCAGATGC -> ATCCAGATGCA
ACATACAACCC -> CATACAACCCT
GTAGTATACTC -> TAGTATACTCG
CGATATTCCGG -> GATATTCCGGC
ATGCAGGACAC -> TGCAGGACACG
TCCGCCTGCAG -> CCGCCTGCAGA
TACAACCCTTG -> ACAACCCTTGG
ACGGGTTAGAA -> CGGGTTAGAAC
GGGAGTCCTGA -> GGAGTCCTGAC
ATCCAGATGCA -> TCCAGATGCAT
GTAGGACCTTG -> TAGGACCTTGC
AAACAGAGTCT -> AACAGAGTCTA
GTTTACGTGGC -> TTTACGTGGCC
GGGAGTGACTA -> GGAGTGACTAC
GCGGGGACTGC -> CGGGGACTGCC
TGCCTGTTTCT -> GCCTGTTTCTC
AGATCCCGTGA -> GATCCCGTGAC
CTTCAATAGAT -> TTCAATAGATG
AGAATGTCTGG -> GAATGTCTGGG
ACCAGTAGACA -> CCAGTAGACAG
CGCCCTTCGCG -> GCCCTTCGCGC
ACAGTAGATTA -> CAGTAGATTAC
TTCTATGATTA -> TCTATGATTAC
TACTGTGCTAG -> ACTGTGCTAGT
CTTACTTATGG -> TTACTTATGGT
GAAGAACCTTC -> AAGAACCTTCT
CATAAATGCAG -> ATAAATGCAGG
TTGGCCATTTT -> TGGCCATTTTC
GTAGGAGTGGA -> TAGGAGTGGAA
GGGCGCTAGAA -> GGCGCTAGAAG
AGAAGTTTACG -> GAAGTTTACGT
ATGTAAAACCG -> TGTAAAACCGA
ATGTGCCCGTG -> TGTGCCCGTGA
CTAAACATCAC -> TAAACATCACA
GCTGCTTCAAT -> CTGCTTCAATA
CTCGTTCATTT -> TCGTTCATTTA
CCCCATACGTT -> CCCATACGTTG
CCATCCCTTGA -> CATCCCTTGAA
CCTCTCGATCA -> CTCTCGATCAC
AGAGGGTGGAA -> GAGGGTGGAAC
GGTGCAGAGGT -> GTGCAGAGGTG
CGTTGGCGAGC -> GTTGGCGAGCA
GTAGTGCCTGT -> TAGTGCCTGTT
TGAGTCAAAGA -> GAGTCAAAGAA
CAACTAGCTGT -> AACTAGCTGTG
ACTTACTTATG -> CTTACTTATGG
ATGAGATCCCG -> TGAGATCCCGT
GTTCGGTGCAG -> TTCGGTGCAGA
CACCTTGTCTT -> ACCTTGTCTTT
CCCTTGAACAG -> CCTTGAACAGG
CCGGGAGTGAC -> CGGGAGTGACT
AGACAAACATG -> GACAAACATGT
GATCGACCTCA -> ATCGACCTCAT
AAAAACCCTCT -> AAAACCCTCTC
GGGGACTGCCA -> GGGACTGCCAA
TAATTTTTGGG -> AATTTTTGGGA
TGCAAGTCCGA -> GCAAGTCCGAG
TGTGCCTCTCG -> GTGCCTCTCGA
GGACGACAGAC -> GACGACAGACT
CGTGAACATGA -> GTGAACATGAA
GCAGAGTAGCC -> CAGAGTAGCCC
ACTACTGACGC -> CTACTGACGCC
TACTCGCTCGC -> ACTCGCTCGCT
ACGAAAGAACC -> CGAAAGAACCC
AGGTCATCATC -> GGTCATCATCT
AAGGGGGGTTT -> AGGGGGGTTTC
AAATGCAGGAC -> AATGCAGGACA
CACGAGAATGA -> ACGAGAATGAT
TGATCTTGGCA -> GATCTTGGCAG
TTTTTCTTATT -> TTTTCTTATTC
CCTGATCTTGG -> CTGATCTTGGC
TCACTCTTTCG -> CACTCTTTCGA
GTCGTAAGACA -> TCGTAAGACAA
AGTAATTATTC -> GTAATTATTCC
CGGATAGCGTA -> GGATAGCGTAA
GCGGCCCTCCT -> CGGCCCTCCTC
TGTGCACCAGT -> GTGCACCAGTA
GTAATTCAGGT -> TAATTCAGGTC
CGGTCCGTTCA -> GGTCCGTTCAT
TTTTGGGAACG -> TTTGGGAACGA
TTGCAAGTCCG -> TGCAAGTCCGA
CTTAAACGTGA -> TTAAACGTGAC
TGCATTGTATT -> GCATTGTATTG
ACCTGCTAGCA -> CCTGCTAGCAA
CCCAAATAGTG -> CCAAATAGTGT
CTGTGGAGCAT -> TGTGGAGCATC
CTGCAGAAACA -> TGCAGAAACAG
TCGTAGGACAC -> CGTAGGACACC
CGAGGGCAGCT -> GAGGGCAGCTA
TGCGAACCCGA -> GCGAACCCGAA
TATGATTACGA -> ATGATTACGAG
ACCCTGGCCTT -> CCCTGGCCTTG
ATTAACATACA -> TTAACATACAC
CACCCATGCCT -> ACCCATGCCTA
ATAAATGCAGG -> TAAATGCAGGA
CATGAGATCCC -> ATGAGATCCCG
GGTGTGCCTCT -> GTGTGCCTCTC
CAGCACCCATG -> AGCACCCATGC
CTCCAGCTCCT -> TCCAGCTCCTA
GAAAGACTCTC -> AAAGACTCTCG
CCGGCCACTCT -> CGGCCACTCTG
AAACCTGGTTC -> AACCTGGTTCC
TTCCACTCGGT -> TCCACTCGGTG
GTAGACAGTAG -> TAGACAGTAGA
TACGGTTCGGT -> ACGGTTCGGTG
CCGAAAGACTC -> CGAAAGACTCT
CCAAAACCTGG -> CAAAACCTGGT
GCGGCGGCCCT -> CGGCGGCCCTC
TAGTAGTGCCT -> AGTAGTGCCTG
CCATGCCTACT -> CATGCCTACTG
TCACAAATGGG -> CACAAATGGGG
GTATAAAAACC -> TATAAAAACCC
ATCATCTTGAC -> TCATCTTGACA
AACCGAAATTG -> ACCGAAATTGC
CTCCGCACACC -> TCCGCACACCC
GCAGATTAATG -> CAGATTAATGG
CTTTGGGTGAC -> TTTGGGTGACT
CAACCCTTGGG -> AACCCTTGGGG
CATGTTTTCCT -> ATGTTTTCCTT
TCCCCAGCTTA -> CCCCAGCTTAG
TGTTGGGATTT -> GTTGGGATTTC
CTAGGACGACA -> TAGGACGACAG
CTGATGTTGGG -> TGATGTTGGGA
GGGGTTTCCAC -> GGGTTTCCACT
GTGTGCCTCTC -> TGTGCCTCTCG
CGCGGCAATAT -> GCGGCAATATT
CATACGTTGAA -> ATACGTTGAAT
CTTGACACAAC -> TTGACACAACG
TAAGGCTGGAT -> AAGGCTGGATC
TAGGGAGGTGA -> AGGGAGGTGAG
GGGGGTTTCCA -> GGGGTTTCCAC
TATTAACCCTT -> ATTAACCCTTA
CCTCGTGAACA -> CTCGTGAACAT
AAGTACTCTTG -> AGTACTCTTGT
TCTGCCTCGTA -> CTGCCTCGTAG
GCTTTGGGTGA -> CTTTGGGTGAC
GTTTATAAACC -> TTTATAAACCG
ACACTCAGCGG -> CACTCAGCGGT
AAGTTTACGTG -> AGTTTACGTGG
CTGCGCGGTTT -> TGCGCGGTTTA
GAGCGTGAAAT -> AGCGTGAAATG
AAGGGCAGTTT -> AGGGCAGTTTA
GCTTAGCTCAC -> CTTAGCTCACT
AGTAGATTACC -> GTAGATTACCT
CGGGGCACCCA -> GGGGCACCCAA
GACCGTAAACA -> ACCGTAAACAT
CAGGTCATCAT -> AGGTCATCATC
CTCTTTCGAGC -> TCTTTCGAGCG
TAAAAGCAGGT -> AAAAGCAGGTA
GACCGAAAGCA -> ACCGAAAGCAC
GGAACGAAAGA -> GAACGAAAGAA
TTACGAGCGTG -> TACGAGCGTGA
TGTCCATTAAT -> GTCCATTAATT
CGACACCCTGA -> GACACCCTGAT
GTATTGCGAAC -> TATTGCGAACC
GTGAGGACCCT -> TGAGGACCCTG
GGGATTTCCTG -> GGATTTCCTGT
TCTCGGGTGTC -> CTCGGGTGTCA
TAAGAGTTACC -> AAGAGTTACCT
GGCCCGGGAGT -> GCCCGGGAGTG
GGGGAGTCCTG -> GGGAGTCCTGA
TTTTCCAAAGC -> TTTCCAAAGCA
AGTCTCGGGTG -> GTCTCGGGTGT
AGTAACAATTA -> GTAACAATTAT
AATTTTTGGGA -> ATTTTTGGGAA
GGGAGGTGTGG -> GGAGGTGTGGT
CGTGAAATGAG -> GTGAAATGAGG
CAATTCGATTC -> AATTCGATTCA
TGACCGTAAAC -> GACCGTAAACA
GGTGGGCTTAG -> GTGGGCTTAGG
CACCAGGGTCT -> ACCAGGGTCTG
CCTCGTAGGAC -> CTCGTAGGACA
CCTTCTACGCG -> CTTCTACGCGC
CTTAGCTCACT -> TTAGCTCACTC
AACAATGAAGA -> ACAATGAAGAA
ACCTGGTTCCG -> CCTGGTTCCGA
CACTCTGTTTG -> ACTCTGTTTGC
CCCGGTTGCCC -> CCGGTTGCCCA
CATTGCTGCTT -> ATTGCTGCTTC
TCCTCTAGGAC -> CCTCTAGGACG
TCGATCACTAA -> CGATCACTAAA
CACTGGGGTTC -> ACTGGGGTTCT
AGACAGTAGAT -> GACAGTAGATT
CGGATTTGGCC -> GGATTTGGCCA
GCGCTAGAAGG -> CGCTAGAAGGA
TTGGGTGACTT -> TGGGTGACTTA
TTAGCCTGCGC -> TAGCCTGCGCG
GGGGTTCTCCG -> GGGTTCTCCGT
TGTTGTAAGTG -> GTTGTAAGTGT
ACATGAAGTTC -> CATGAAGTTCA
CCTCCTCTAGG -> CTCCTCTAGGA
AGTGTCACGGT -> GTGTCACGGTG
CTCTTCTTCCC -> TCTTCTTCCCT
TCAACTAGCTG -> CAACTAGCTGT
ATTCCCTCAGG -> TTCCCTCAGGT
GCTCGCTCAAC -> CTCGCTCAACT
CTAGTCCTCGT -> TAGTCCTCGTG
CGCACGAATGA -> GCACGAATGAA
CTTCAAGGGAG -> TTCAAGGGAGT
GTTTAACCACA -> TTTAACCACAG
TAGGTCCGCCT -> AGGTCCGCCTG
AATGCAGGACA -> ATGCAGGACAC
CGCTCAATCGC -> GCTCAATCGCC
CAACATGACCG -> AACATGACCGT
CCCAGCTTAGC -> CCAGCTTAGCT
GACAGACTAGC -> ACAGACTAGCC
TAGACAGTAGA -> AGACAGTAGAT
ATACACCAACC -> TACACCAACCA
TTATCCAGATG -> TATCCAGATGC
TTTCTCACGAG -> TTCTCACGAGA
CCAAGTACTCT -> CAAGTACTCTT
GCCTCGTAGGA -> CCTCGTAGGAC
GTCTGGGAGTT -> TCTGGGAGTTA
CATGTTAGGGA -> ATGTTAGGGAG
TCCTAAACCTG -> CCTAAACCTGA
CTGGATCCTCG -> TGGATCCTCGC
TAGTGCCTGTT -> AGTGCCTGTTT
AGTCGGGGCAC -> GTCGGGGCACC
GTTGGGATTTC -> TTGGGATTTCC
TGCGGCAGAGT -> GCGGCAGAGTA
ATTACGAGCGT -> TTACGAGCGTG
TCTTTCGAGCG -> CTTTCGAGCGG
CTCGCACGAAT -> TCGCACGAATG
CTCCGTAATCA -> TCCGTAATCAC
AGACTCTCGTT -> GACTCTCGTTC
CCAATTCGATT -> CAATTCGATTC
ACCACCAATGG -> CCACCAATGGA
TCTCGTTCATT -> CTCGTTCATTT
GTTAGAACTCT -> TTAGAACTCTT
GACGGATTTGG -> ACGGATTTGGC
GGGTGTCACAG -> GGTGTCACAGC
ACCATCGGATC -> CCATCGGATCG
TCTTGGCAGAT -> CTTGGCAGATT
TTAGGCATGAG -> TAGGCATGAGA
TATAAACCGCT -> ATAAACCGCTA
ATCAGCCGAAA -> TCAGCCGAAAG
GCCAGGGCTAT -> CCAGGGCTATG
TTAGGCCCGGG -> TAGGCCCGGGA
CGGATTCGACG -> GGATTCGACGG
CATTATCCAGA -> ATTATCCAGAT
AGCTCCTAAAC -> GCTCCTAAACC
CTAGCTGTGAG -> TAGCTGTGAGT
GAGTAGCCCGG -> AGTAGCCCGGT
GACTACGAGGC -> ACTACGAGGCT
TTATAAACCGC -> TATAAACCGCT
TCACGCGGGGA -> CACGCGGGGAC
TTCTTATTCAG -> TCTTATTCAGT
CAAACATGTTT -> AAACATGTTTT
TGGGGTTCTCC -> GGGGTTCTCCG
CACGGTATAAA -> ACGGTATAAAA
CCTTGCCTAAC -> CTTGCCTAACA
GCCCGGGAGTG -> CCCGGGAGTGA
CCTGAGCTGAT -> CTGAGCTGATG
GACAACATGAC -> ACAACATGACC
GTCTGCCTCGT -> TCTGCCTCGTA
GCAGGTACGGG -> CAGGTACGGGT
GATGTAGGAGT -> ATGTAGGAGTG
GAGTCCTGACG -> AGTCCTGACGC
AATGGATAATG -> ATGGATAATGA
CGAAAGACTCT -> GAAAGACTCTC
GTTTTCCTTCG -> TTTTCCTTCGG
AGCCCGGTTGC -> GCCCGGTTGCC
TGGGATTTCCT -> GGGATTTCCTG
TTTGCATTGTA -> TTGCATTGTAT
GCAAGTCCGAG -> CAAGTCCGAGG
CTGAGCTGATG -> TGAGCTGATGT
AGGGGGGTTTC -> GGGGGGTTTCC
TGGCCTGGAAG -> GGCCTGGAAGT
ACTCTTCTTCC -> CTCTTCTTCCC
CTGCCGCGGCA -> TGCCGCGGCAA
CCCTCAGGTAA -> CCTCAGGTAAC
AACAGAGTCTA -> ACAGAGTCTAC
TCGCTCAACTA -> CGCTCAACTAG
CAGCTAGTCCT -> AGCTAGTCCTC
TCATTATCCAG -> CATTATCCAGA
AGAACTCTTCT -> GAACTCTTCTT
TGGGAACGAAA -> GGGAACGAAAG
CAAAGAAGTTT -> AAAGAAGTTTA
AGTTATGACGA -> GTTATGACGAT
TGATCAGCCGA -> GATCAGCCGAA
GCCTCTCGATC -> CCTCTCGATCA
GACTGTGGAGC -> ACTGTGGAGCA
TATAAAAACCC -> ATAAAAACCCT
TGTGGAGCATC -> GTGGAGCATCG
CTCTGTGAGGA -> TCTGTGAGGAC
GGGTTTCCACT -> GGTTTCCACTC
TAAGTGTCTCT -> AAGTGTCTCTC
TATTCAGTCTC -> ATTCAGTCTCG
CAAAACTAAAC -> AAAACTAAACA
ACTCAGCGGTA -> CTCAGCGGTAA
CAGTGTGACTG -> AGTGTGACTGT
AGTCCTCGTGA -> GTCCTCGTGAA
TTAACCCTTAG -> TAACCCTTAGG
TCCTGACCGAA -> CCTGACCGAAA
TGGCAGATTAA -> GGCAGATTAAT
GCGAACCCGAA -> CGAACCCGAAG
CTCGTGAACAT -> TCGTGAACATG
GGATTCGACGG -> GATTCGACGGA
GCCACTCTGTT -> CCACTCTGTTT
TTCGACGGACA -> TCGACGGACAG
TGCTGCTTCAA -> GCTGCTTCAAT
GCCTGGAAGTA -> CCTGGAAGTAG
TGCAAGATCCG -> GCAAGATCCGG
GGAGGTGAGAC -> GAGGTGAGACT
TTGTATTGCGA -> TGTATTGCGAA
GCGTAATTCAG -> CGTAATTCAGG
ATTAGTAATTA -> TTAGTAATTAT
TGGCCATTTTC -> GGCCATTTTCC
TTCCAAAGCAT -> TCCAAAGCATA
AAAACTAAACA -> AAACTAAACAT
AATTTTCTAAT -> ATTTTCTAATA
AAAGCGATGAG -> AAGCGATGAGT
CCGTAAACATG -> CGTAAACATGT
CCTCCACATAC -> CTCCACATACA
GTGGGCTTAGG -> TGGGCTTAGGC
TAATTATTCCC -> AATTATTCCCT
AGCGGTAAGAG -> GCGGTAAGAGT
AATCTTAGTTT -> ATCTTAGTTTT
GAGCTGATGTT -> AGCTGATGTTG
TAATCATGTCT -> AATCATGTCTA
GTTGAATTGCA -> TTGAATTGCAA
ATTACCTGCTA -> TTACCTGCTAG
AAATTGCAAGT -> AATTGCAAGTC
ATATCTTCAAG -> TATCTTCAAGG
AATTATTCCCT -> ATTATTCCCTC
TTAGTAATTAT -> TAGTAATTATT
TCCGATATTCC -> CCGATATTCCG
ACGGACAGACC -> CGGACAGACCA
GACAAACATGT -> ACAAACATGTT
CCGAAGAGGGT -> CGAAGAGGGTG
TTATGGTAGGT -> TATGGTAGGTC
CGACCATGTTT -> GACCATGTTTA
GGATGTAGGAG -> GATGTAGGAGT
CCCTGCCGCGG -> CCTGCCGCGGC
CCGATGCCTCT -> CGATGCCTCTA
CTGACGCCTCC -> TGACGCCTCCA
TTCCTGTATGA -> TCCTGTATGAT
ACCATGTTTAC -> CCATGTTTACG
GATCCCGTGAC -> ATCCCGTGACT
TCTAGCTTCTA -> CTAGCTTCTAT
AAGCACCGCTC -> AGCACCGCTCA
CTTGTCTTTTC -> TTGTCTTTTCC
TCATGGTCGGT -> CATGGTCGGTC
GCCCGTGATCA -> CCCGTGATCAG
TTGTTGTAAGT -> TGTTGTAAGTG
CTAATATGCGA -> TAATATGCGAT
GCACGAATGAA -> CACGAATGAAT
CTCACGAGAAT -> TCACGAGAATG
CGTGATGTGCC -> GTGATGTGCCC
GAATGATGCCA -> AATGATGCCAG
CATTAGTAGTG -> ATTAGTAGTGC
GATCAGCGGCG -> ATCAGCGGCGG
ACGGTTCGGTG -> CGGTTCGGTGC
TGATCAGCGGC -> GATCAGCGGCG
GGTTGCCCACC -> GTTGCCCACCA
CGCGGGGACTG -> GCGGGGACTGC
GACTGCCATCC -> ACTGCCATCCC
TATCTCCAGCT -> ATCTCCAGCTC
AACCACAGTTG -> ACCACAGTTGC
TGCCTAACAAT -> GCCTAACAATG
AAGCAGGTACG -> AGCAGGTACGG
TGCGATTAACA -> GCGATTAACAT
TGAGCTGATGT -> GAGCTGATGTT
CCGTAATCACG -> CGTAATCACGG
GGGCGGTCCGT -> GGCGGTCCGTT
GATGCCTCTAA -> ATGCCTCTAAT
GTAGCTCCTAG -> TAGCTCCTAGT
ATGTCCATTAA -> TGTCCATTAAT
CGCGCTATTAA -> GCGCTATTAAC
GTGCCTGTTTC -> TGCCTGTTTCT
CATTAATTTTT -> ATTAATTTTTG
CTGTTTGCGTA -> TGTTTGCGTAC
GCCTGTTTCTC -> CCTGTTTCTCA
CATTAAAGCAC -> ATTAAAGCACC
AAGACTCTCGT -> AGACTCTCGTT
TTCGCGCAGCA -> TCGCGCAGCAG
GTAATCACGGT -> TAATCACGGTA
CTCCCCAGCTT -> TCCCCAGCTTA
AGTGCCTGTTT -> GTGCCTGTTTC
CTAGTATCCAA -> TAGTATCCAAG
GATCCGGGGAG -> ATCCGGGGAGT
TTAGCTCACTC -> TAGCTCACTCT
TAGAACTCTTC -> AGAACTCTTCT
ACGAGGCTTAA -> CGAGGCTTAAA
CGCGCTATCAA -> GCGCTATCAAT
CAGGTAACCAA -> AGGTAACCAAT
GCACCCATGCC -> CACCCATGCCT
AGTAGTATACT -> GTAGTATACTC
CCGTGACTACG -> CGTGACTACGA
ACCTGAGCTGA -> CCTGAGCTGAT
GCAGCTAGTCC -> CAGCTAGTCCT
TGACGATTGTG -> GACGATTGTGA
TACGCGCTATC -> ACGCGCTATCA
GAAATATCTTC -> AAATATCTTCA
ACCCTTAGGTA -> CCCTTAGGTAG
CTCATTATCCA -> TCATTATCCAG
TGCCCACCAGG -> GCCCACCAGGG
TCTATGATTAC -> CTATGATTACG
AATGATTCGAT -> ATGATTCGATT
AATCATGTCTA -> ATCATGTCTAG
CTAGCCCACTG -> TAGCCCACTGG
AGTGTGCACCA -> GTGTGCACCAG
GCAAGTTAGCC -> CAAGTTAGCCT
TCGAGCGGATA -> CGAGCGGATAC
TCGTGAACATG -> CGTGAACATGA
CAGTCTCGGGT -> AGTCTCGGGTG
TGTAAAACCGA -> GTAAAACCGAA
TTGGGAACGAA -> TGGGAACGAAA
TAGGGAGGTGT -> AGGGAGGTGTG
CGTTAGGCCCG -> GTTAGGCCCGG
CAGCAGTGTGA -> AGCAGTGTGAC
TTAACATACAC -> TAACATACACT
AGCCGTTAGGC -> GCCGTTAGGCC
GTGCCCGTGAT -> TGCCCGTGATC
GGAGTTATGAC -> GAGTTATGACG
ACCCAAAGGGG -> CCCAAAGGGGG
TCCAAGTACTC -> CCAAGTACTCT
GGATTTCCTGT -> GATTTCCTGTA
GGTAACCAATT -> GTAACCAATTC
TTTGGCCATTG -> TTGGCCATTGC
GTCTAGCTTCT -> TCTAGCTTCTA
GGAGTGGAAAT -> GAGTGGAAATA
CAGAGTCTACC -> AGAGTCTACCA
ACGTGGCCTGG -> CGTGGCCTGGA
AAGAACCTTCT -> AGAACCTTCTA
GGTGACAACAT -> GTGACAACATG
ACAACGGTGAC -> CAACGGTGACG
AACTCTTCTTC -> ACTCTTCTTCC
AAACATGTTAG -> AACATGTTAGG
TATTGCGAACC -> ATTGCGAACCC
CTATCTCCAGC -> TATCTCCAGCT
GCATAAATGCA -> CATAAATGCAG
CATCATCTTGA -> ATCATCTTGAC
AATATCTTCAA -> ATATCTTCAAG
TGGCCTTGATA -> GGCCTTGATAT
CTTTCGACACA -> TTTCGACACAT
GGCGAGCATAG -> GCGAGCATAGC
AATGGGGCAAG -> ATGGGGCAAGT
GATGAGTCGGG -> ATGAGTCGGGG
CTAACAATGAA -> TAACAATGAAG
ATTAGGGAGGT -> TTAGGGAGGTG
CCCGGCCACTC -> CCGGCCACTCT
AGCAGTTCCTG -> GCAGTTCCTGA
GGGTTCTCCGT -> GGTTCTCCGTA
AATGGGGCGCT -> ATGGGGCGCTA
ATCTTGACACA -> TCTTGACACAA
GGTTCTCCGTA -> GTTCTCCGTAA
AGGGAGGTGAG -> GGGAGGTGAGA
GCGATGAGTCG -> CGATGAGTCGG
ACCACAGTTGC -> CCACAGTTGCA
ATACAACCCTT -> TACAACCCTTG
ATCCCTTGAAC -> TCCCTTGAACA
TGAGTCGGGGC -> GAGTCGGGGCA
CGGCCCTCCTC -> GGCCCTCCTCT
GCGGTAAGAGT -> CGGTAAGAGTT
AGCTGATGTTG -> GCTGATGTTGG
GTTTCTCACGA -> TTTCTCACGAG
TAACAATTATT -> AACAATTATTC
TTCATTGGCCA -> TCATTGGCCAT
CGGTCACCTTT -> GGTCACCTTTC
ATATTCCGGCG -> TATTCCGGCGG
AGATGATCAGC -> GATGATCAGCG
CAGAGGTGGGC -> AGAGGTGGGCT
TCAGCCGAAAG -> CAGCCGAAAGA
CGGCCACTCTG -> GGCCACTCTGT
TCCTCTGTGAG -> CCTCTGTGAGG
GCGGCAGAGTA -> CGGCAGAGTAG
GAGGTGGGCTT -> AGGTGGGCTTA
TATTACGGTTC -> ATTACGGTTCG
GGCATGAGATC -> GCATGAGATCC
TGTTAAAAGCA -> GTTAAAAGCAG
CGCTATCAATA -> GCTATCAATAA
CTCGCTCAACT -> TCGCTCAACTA
TCGGTCTTAGC -> CGGTCTTAGCA
CCCTGATCTTG -> CCTGATCTTGG
GGGGCACCCAA -> GGGCACCCAAA
TTACCTGCTAG -> TACCTGCTAGC
CTAAAGCCGTT -> TAAAGCCGTTA
CCTGCGCGGTT -> CTGCGCGGTTT
TGAATACACCA -> GAATACACCAA
TCTCGATCACT -> CTCGATCACTA
CTGACGCCGGT -> TGACGCCGGTG
AGTTACCTTTA -> GTTACCTTTAA
TTTCTTATTCA -> TTCTTATTCAG
ACCCTGCGTTG -> CCCTGCGTTGG
TAGATGATCAG -> AGATGATCAGC
AGCATAGCGGT -> GCATAGCGGTC
TGCTAGTAGTA -> GCTAGTAGTAT
AGTTAGCCTGC -> GTTAGCCTGCG
TAGTGTGCACC -> AGTGTGCACCA
GAGGACCCTGG -> AGGACCCTGGC
CTTGGGGCGGT -> TTGGGGCGGTC
TTACGTGGCCT -> TACGTGGCCTG
GTCCGAGGGCA -> TCCGAGGGCAG
TAGCAACCGAA -> AGCAACCGAAA
ACTACGAGGCT -> CTACGAGGCTT
CATACACTCAG -> ATACACTCAGC
GCCGAAAGACT -> CCGAAAGACTC
GCGTACGAGGT -> CGTACGAGGTG
CTAGAAGGAAC -> TAGAAGGAACC
TGAACAGGGAA -> GAACAGGGAAT
TCGACGGACAG -> CGACGGACAGA
GGAGAAGAACG -> GAGAAGAACGA
GGGAGTACCCT -> GGAGTACCCTG
CGAGCATAGCG -> GAGCATAGCGG
CAGGGAATTTT -> AGGGAATTTTC
TCTTATTCAGT -> CTTATTCAGTC
TGGGAGTTATG -> GGGAGTTATGA
TGTGAGGACCC -> GTGAGGACCCT
TGCAATCTTAG -> GCAATCTTAGT
TTGCGAACCCG -> TGCGAACCCGA
CATTTATGTTA -> ATTTATGTTAA
GTCTACCACCA -> TCTACCACCAA
CCATTAATTTT -> CATTAATTTTT
GCCCACTGGGG -> CCCACTGGGGT
ATGGTAGGTCC -> TGGTAGGTCCG
TTCAATAGATG -> TCAATAGATGA
GTAACGAATAT -> TAACGAATATT
AGTCCGAGGGC -> GTCCGAGGGCA
GAGACTGCCAT -> AGACTGCCATC
CACAGCAGTTC -> ACAGCAGTTCC
TTGACACAACG -> TGACACAACGG
ACTGTGGAGCA -> CTGTGGAGCAT
GATCATGGTCG -> ATCATGGTCGG
TCTCCGTAATC -> CTCCGTAATCA
GCTATGTCCAT -> CTATGTCCATT
ACAATGAAGAA -> CAATGAAGAAC
CCTGTATGATG -> CTGTATGATGT
ATAGCGGTCAC -> TAGCGGTCACC
GGTGCGGCAGA -> GTGCGGCAGAG
GATTTGGCCAT -> ATTTGGCCATT
ATGGGGCAAGT -> TGGGGCAAGTT
GCGCAGTCGAC -> CGCAGTCGACA
CGCTCGCTCAA -> GCTCGCTCAAC
CGGTTTATAAA -> GGTTTATAAAC
ACTTATGGTAG -> CTTATGGTAGG
CACTAAAGGGC -> ACTAAAGGGCA
AGTTCCTGACC -> GTTCCTGACCG
CGAGCGTGAAA -> GAGCGTGAAAT
GCTTCTATGAT -> CTTCTATGATT
GTAGGTCCGCC -> TAGGTCCGCCT
CCACTGGGGTT -> CACTGGGGTTC
TCTCCAGCTCC -> CTCCAGCTCCT
ATTAAAGCACC -> TTAAAGCACCG
GACACGGCCAG -> ACACGGCCAGG
TCCACTCGGTG -> CCACTCGGTGA
AAGAGGGTGGA -> AGAGGGTGGAA
GCCTACTGTGC -> CCTACTGTGCT
TGCCTCTCGAT -> GCCTCTCGATC
TTAATTTTTGG -> TAATTTTTGGG
TTATTCCCTCA -> TATTCCCTCAG
CCTGCCGCGGC -> CTGCCGCGGCA
GGCGCTAGAAG -> GCGCTAGAAGG
TACTCTTGTTG -> ACTCTTGTTGT
GAAGTTTACGT -> AAGTTTACGTG
GCAGTGTGACT -> CAGTGTGACTG
GTGATCAGCCG -> TGATCAGCCGA
CAACCATCGGA -> AACCATCGGAT
CATTAGGGAGG -> ATTAGGGAGGT
TCAAGGGAGTA -> CAAGGGAGTAC
GGGCAGTTTAA -> GGCAGTTTAAC
CACGCGCAGTC -> ACGCGCAGTCG
CTCTAATCATG -> TCTAATCATGT
GTTGCCCACCA -> TTGCCCACCAG
CCGTTCATTGG -> CGTTCATTGGC
AATTATTCGCG -> ATTATTCGCGC
CCATACGTTGA -> CATACGTTGAA
TAAACCGCTAG -> AAACCGCTAGT
TGCAGAAACAG -> GCAGAAACAGA
AGCAGGTACGG -> GCAGGTACGGG
TCAATCGCCCT -> CAATCGCCCTT
TGCGCGGTTTA -> GCGCGGTTTAT
TCACTAAAGCC -> CACTAAAGCCG
GCTATCAATAA -> CTATCAATAAG
TCAGCGGCGGC -> CAGCGGCGGCC
CTGTTTCTCAC -> TGTTTCTCACG
AGCTGTGAGTC -> GCTGTGAGTCA
TCCTGTATGAT -> CCTGTATGATG
GCAGCACCCAT -> CAGCACCCATG
ACTGGATCCTC -> CTGGATCCTCG
TATCACGCGGG -> ATCACGCGGGG
TCGCTCGCTCA -> CGCTCGCTCAA
TGTGACTGTGG -> GTGACTGTGGA
GCACTAAAGGG -> CACTAAAGGGC
TGACTTACTTA -> GACTTACTTAT
CACCAACCATC -> ACCAACCATCG
AATTCGATTCA -> ATTCGATTCAC
GACTACTGACG -> ACTACTGACGC
AGGTACGGGTT -> GGTACGGGTTA
GATGTGCCCGT -> ATGTGCCCGTG
CGTGGCCTGGA -> GTGGCCTGGAA
AGATTACCTGC -> GATTACCTGCT
GTGCAGAGGTG -> TGCAGAGGTGG
GCTTCAATAGA -> CTTCAATAGAT
TCGACACCCTG -> CGACACCCTGA
ATGTTAAAAGC -> TGTTAAAAGCA
CTAGTAACAAT -> TAGTAACAATT
ATGACCGTAAA -> TGACCGTAAAC
CAGACTAGCCC -> AGACTAGCCCA
CGAGGTGTGCC -> GAGGTGTGCCT
AATAGATGATC -> ATAGATGATCA
TCCTTCGGATT -> CCTTCGGATTC
GATTCACTACT -> ATTCACTACTC
GCCGTTAGGCC -> CCGTTAGGCCC
TTTTCTAATAT -> TTTCTAATATG
TCTAGGACGAC -> CTAGGACGACA
TGCCATCCCTT -> GCCATCCCTTG
TTGCAATCTTA -> TGCAATCTTAG
AGCACCCATGC -> GCACCCATGCC
CGTGACGTGCA -> GTGACGTGCAA
ACGGTGACGGA -> CGGTGACGGAT
CGTTGAATTGC -> GTTGAATTGCA
GAGTTATGACG -> AGTTATGACGA
CCGCCCGGTAG -> CGCCCGGTAGG
GCGTGAAATGA -> CGTGAAATGAG
CGTCCAAAACT -> GTCCAAAACTA
CCACTCGGTGA -> CACTCGGTGAG
GAAATTGCAAG -> AAATTGCAAGT
TGTATGATGTA -> GTATGATGTAA
ACCTTTCGACA -> CCTTTCGACAC
GTAGCCCGGTT -> TAGCCCGGTTG
ATTTTCTAATA -> TTTTCTAATAT
GGTCTGCCTCG -> GTCTGCCTCGT
ACTGACGCCGG -> CTGACGCCGGT
AGGGTCTGCCT -> GGGTCTGCCTC
ACATACACTCA -> CATACACTCAG
CTAAAGGGCAG -> TAAAGGGCAGT
TAAAAACCCTC -> AAAAACCCTCT
TTCAGTCTCGG -> TCAGTCTCGGG
CTCTCCCCAGC -> TCTCCCCAGCT
CAACCGAAATT -> AACCGAAATTG
AGTCCTGACGC -> GTCCTGACGCC
ACCGCTAGTAA -> CCGCTAGTAAC
TAATGATTCGA -> AATGATTCGAT
GGTAGGACCTT -> GTAGGACCTTG
TCCCTCAGGTA -> CCCTCAGGTAA
AGCGGCGGCCC -> GCGGCGGCCCT
GCCATTGCTGC -> CCATTGCTGCT
ACTCGCTCGCT -> CTCGCTCGCTC
TGATTACGAGC -> GATTACGAGCG
GGCCACTCTGT -> GCCACTCTGTT
ATAAAAACCCT -> TAAAAACCCTC
CCAAAGGGGGG -> CAAAGGGGGGT
TCCCTGCCGCG -> CCCTGCCGCGG
TGGAGCATCGG -> GGAGCATCGGA
CCTCTGTGAGG -> CTCTGTGAGGA
CTACCACCAAT -> TACCACCAATG
ACATCACAAAT -> CATCACAAATG
TGCGTACGAGG -> GCGTACGAGGT
GCCTGCAGAAA -> CCTGCAGAAAC
TTAGTAGTGCC -> TAGTAGTGCCT
CCATTTTCCAA -> CATTTTCCAAA
GAATTGCAATC -> AATTGCAATCT
TATCAATAAGG -> ATCAATAAGGC
GCCCTCCTCTA -> CCCTCCTCTAG
CTGGAAGTAGG -> TGGAAGTAGGT
GTATCCAAGTA -> TATCCAAGTAC
TGGTTCCGATA -> GGTTCCGATAT
GGCCATTTTCC -> GCCATTTTCCA
CGGACAGACCA -> GGACAGACCAG
TGAGATCCCGT -> GAGATCCCGTG
TTCTCACGAGA -> TCTCACGAGAA
GATTACGAGCG -> ATTACGAGCGT
AGCCTGCGCGG -> GCCTGCGCGGT
AATATTCCTCT -> ATATTCCTCTG
CTCTCGTTCAT -> TCTCGTTCATT
ATACCGATGCC -> TACCGATGCCT
CGGCAGAGTAG -> GGCAGAGTAGC
CGAATGGGGCG -> GAATGGGGCGC
AGCCGAAAGAC -> GCCGAAAGACT
GAGGGCAGCTA -> AGGGCAGCTAG
TCGCGCAGCAG -> CGCGCAGCAGT
CTTGGCAGATT -> TTGGCAGATTA
TCAATAAGGCT -> CAATAAGGCTG
GTGACGGATTT -> TGACGGATTTG
GGAGCATCGGA -> GAGCATCGGAT
TCGACACATCG -> CGACACATCGT
CGTAATTCAGG -> GTAATTCAGGT
AAATAGTGTGC -> AATAGTGTGCA
CCCGGTAGGAC -> CCGGTAGGACC
CATGGTCGGTC -> ATGGTCGGTCT
AGTAGCCCGGT -> GTAGCCCGGTT
GGCCTTGATAT -> GCCTTGATATC
AGCGGATACCG -> GCGGATACCGA
TCCGTAATCAC -> CCGTAATCACG
CAGTAGACAGT -> AGTAGACAGTA
ATGACGATTGT -> TGACGATTGTG
ACCAATGGATA -> CCAATGGATAA
TTGAACAGGGA -> TGAACAGGGAA
ATCTTGGCAGA -> TCTTGGCAGAT
TTTCTAATATG -> TTCTAATATGC
GATTACCTGCT -> ATTACCTGCTA
CCTCAGGTAAC -> CTCAGGTAACC
GGAAATATCTT -> GAAATATCTTC
GGATCGACCTC -> GATCGACCTCA
ACTAAAGCCGT -> CTAAAGCCGTT
AATTGCAAGTC -> ATTGCAAGTCC
TGGGGCGGTCC -> GGGGCGGTCCG
GATACCGATGC -> ATACCGATGCC
AACCCTTGGGG -> ACCCTTGGGGC
CAGCCGAAAGA -> AGCCGAAAGAC
ACGCGGGGACT -> CGCGGGGACTG
TAACAATGAAG -> AACAATGAAGA
GACGCCGGTGC -> ACGCCGGTGCG
GCAGAAACAGA -> CAGAAACAGAG
TGGGTGACTTA -> GGGTGACTTAC
ATTCAGTCTCG -> TTCAGTCTCGG
GAGGGTGGAAC -> AGGGTGGAACA
AAACTAAACAT -> AACTAAACATC
ACGCGCAGTCG -> CGCGCAGTCGA
AGCACCTTGTC -> GCACCTTGTCT
CCTTGGGGCGG -> CTTGGGGCGGT
TTCTAATATGC -> TCTAATATGCG
TTTCCCGGCCA -> TTCCCGGCCAC
CCCGAAGAGGG -> CCGAAGAGGGT
CAATGGATAAT -> AATGGATAATG
AACCTTCTACG -> ACCTTCTACGC
CCAGGGTCTGC -> CAGGGTCTGCC
ATTAGTAGTGC -> TTAGTAGTGCC
ATCACAAATGG -> TCACAAATGGG
AAGCGATGAGT -> AGCGATGAGTC
CCTTTCGACAC -> CTTTCGACACA
AGGTGTGGTTC -> GGTGTGGTTCC
TCTTAGCACTA -> CTTAGCACTAA
TGATGTAAAAC -> GATGTAAAACC
CGTGTAACGAA -> GTGTAACGAAT
GAAGGAACCGC -> AAGGAACCGCC
TCAAAGAAGTT -> CAAAGAAGTTT
ACAGGGAATTT -> CAGGGAATTTT
GGTTCCATTAG -> GTTCCATTAGT
ATATCACGCGG -> TATCACGCGGG
TGGCCATTGCT -> GGCCATTGCTG
ATTAATTTTTG -> TTAATTTTTGG
AACCTGGTTCC -> ACCTGGTTCCG
TTAAAAGCAGG -> TAAAAGCAGGT
GCATCGGATGT -> CATCGGATGTA
GATGTTGGGAT -> ATGTTGGGATT
AAGTCCGAGGG -> AGTCCGAGGGC
GGGGGGTTTCC -> GGGGGTTTCCA
CTTGTTGTAAG -> TTGTTGTAAGT
CCGCTCAATCG -> CGCTCAATCGC
CCTTGTCTTTT -> CTTGTCTTTTC
TCCGTTCATTG -> CCGTTCATTGG
AAGTGTCACGG -> AGTGTCACGGT
AGCTTCTATGA -> GCTTCTATGAT
TCCATTAATTT -> CCATTAATTTT
ACATTAGGGAG -> CATTAGGGAGG
TGACTGTGGAG -> GACTGTGGAGC
AAAAGCAGGTA -> AAAGCAGGTAC
ACAAATGGGGC -> CAAATGGGGCA
TTTCCAAAGCA -> TTCCAAAGCAT
ATTCGATTAGA -> TTCGATTAGAA
CCTATCTCCAG -> CTATCTCCAGC
ACCTTGTCTTT -> CCTTGTCTTTT
TCGGATCGACC -> CGGATCGACCT
CCCAAAGGGGG -> CCAAAGGGGGG
CGGTGACAACA -> GGTGACAACAT
ACCGAAATTGC -> CCGAAATTGCA
TGCCATTAAAG -> GCCATTAAAGC
GAAAGAACCCA -> AAAGAACCCAA
ATCAGCGGCGG -> TCAGCGGCGGC
TCCTAGTATCC -> CCTAGTATCCA
TTCCCTGCCGC -> TCCCTGCCGCG
CGGTTGCCCAC -> GGTTGCCCACC
GTTCCGATATT -> TTCCGATATTC
CAATATTCCTC -> AATATTCCTCT
CCCCAGCTTAG -> CCCAGCTTAGC
CTCGTAGGACA -> TCGTAGGACAC
GGCTATGTCCA -> GCTATGTCCAT
TAGGCCCGGGA -> AGGCCCGGGAG
ATCTCCAGCTC -> TCTCCAGCTCC
GGGAGTTATGA -> GGAGTTATGAC
CTGCTAGCAAC -> TGCTAGCAACC
ATGTTAGGGAG -> TGTTAGGGAGG
ACGGTGACAAC -> CGGTGACAACA
CTCCTAGTATC -> TCCTAGTATCC
GCCGCGGCAAT -> CCGCGGCAATA
GAGGTGAGACT -> AGGTGAGACTG
TGACGCCTCCA -> GACGCCTCCAC
AACTAGCTGTG -> ACTAGCTGTGA
AGACTAGCCCA -> GACTAGCCCAC
GACGGACAGAC -> ACGGACAGACC
ACACAACGGTG -> CACAACGGTGA
AGTGTCTCTCC -> GTGTCTCTCCG
AGAACCTTCTA -> GAACCTTCTAC
TCCTGACGCCT -> CCTGACGCCTC
CTTCTATGATT -> TTCTATGATTA
CCTAGTATCCA -> CTAGTATCCAA
TTAGAACTCTT -> TAGAACTCTTC
GCGCTATTAAC -> CGCTATTAACC
TAAACCTGAGC -> AAACCTGAGCT
CGATTAGAATG -> GATTAGAATGT
AGGTGTGCCTC -> GGTGTGCCTCT
GTAATTATTCC -> TAATTATTCCC
ACAGCAGTTCC -> CAGCAGTTCCT
TTTCCACTCGG -> TTCCACTCGGT
ATTATTCGCGC -> TTATTCGCGCA
GAATGGGGCGC -> AATGGGGCGCT
GAGTGACTACT -> AGTGACTACTG
ACCGCCCGGTA -> CCGCCCGGTAG
GTTCATTTATG -> TTCATTTATGT
TATACTCGCTC -> ATACTCGCTCG
AAGGCTGGATC -> AGGCTGGATCA
AAACATCACAA -> AACATCACAAA
CCCACCAGGGT -> CCACCAGGGTC
ACATGACCGTA -> CATGACCGTAA
TACCGATGCCT -> ACCGATGCCTC
AAGAGTTACCT -> AGAGTTACCTT
CACGGCCAGGG -> ACGGCCAGGGC
TGTAAGTGTCT -> GTAAGTGTCTC
CGAAATTGCAA -> GAAATTGCAAG
TTACGGTTCGG -> TACGGTTCGGT
GGGTTAGAACT -> GGTTAGAACTC
TGTTTTCCTTC -> GTTTTCCTTCG
GAGTCAAAGAA -> AGTCAAAGAAG
AGGTCCGCCTG -> GGTCCGCCTGC
GTGCCATTAAA -> TGCCATTAAAG
TCGTTTTTCTT -> CGTTTTTCTTA
GAAGAACGACC -> AAGAACGACCA
CGGGTGTCACA -> GGGTGTCACAG
AAAACCTGGTT -> AAACCTGGTTC
AAGTAGGTGCC -> AGTAGGTGCCA
TCACAGCAGTT -> CACAGCAGTTC
TTCCATTAGTA -> TCCATTAGTAG
CATCGGATCGA -> ATCGGATCGAC
GTTTCCACTCG -> TTTCCACTCGG
CCACCAGGGTC -> CACCAGGGTCT
GACCATGTTTA -> ACCATGTTTAC
CTTGATATCAC -> TTGATATCACG
AATTAGTAATT -> ATTAGTAATTA
GGTAAGAGTTA -> GTAAGAGTTAC
TCGTGATGTGC -> CGTGATGTGCC
TAGCCCACTGG -> AGCCCACTGGG
ACACGGCCAGG -> CACGGCCAGGG
CATTTTCCAAA -> ATTTTCCAAAG
GCGCTATCAAT -> CGCTATCAATA
GCGCAGCAGTG -> CGCAGCAGTGT
GCTTAGGCATG -> CTTAGGCATGA
ACACCCCATAC -> CACCCCATACG
CTACTCGTGAT -> TACTCGTGATG
AAGAACCCAAA -> AGAACCCAAAT
TGTCTGGGAGT -> GTCTGGGAGTT
GAACTCTTCTT -> AACTCTTCTTC
GTGCGGCAGAG -> TGCGGCAGAGT
GCGCGGTTTAT -> CGCGGTTTATA
TTGGCCATTGC -> TGGCCATTGCT
CATGTCTAGCT -> ATGTCTAGCTT
ACTCTTTCGAG -> CTCTTTCGAGC
TCTGGGAGTTA -> CTGGGAGTTAT
GGACACGGCCA -> GACACGGCCAG
GTCTTAGCACT -> TCTTAGCACTA
ACAACATGACC -> CAACATGACCG
CCGGGGAGTCC -> CGGGGAGTCCT
AAGTTAGCCTG -> AGTTAGCCTGC
CATGCCTACTG -> ATGCCTACTGT
GGAACATTAGG -> GAACATTAGGG
GATCCTCGCAC -> ATCCTCGCACG
CATCGTTTTTC -> ATCGTTTTTCT
ACGCCGGTGCG -> CGCCGGTGCGG
TAACCACAGTT -> AACCACAGTTG
CGAATGAATAC -> GAATGAATACA
GATTAATGGGA -> ATTAATGGGAG
AAAGACTCTCG -> AAGACTCTCGT
ATCACGGTATA -> TCACGGTATAA
ATGTAGGAGTG -> TGTAGGAGTGG
TTCCTGACCGA -> TCCTGACCGAA
AAGATCCGGGG -> AGATCCGGGGA
ACCCTGATCTT -> CCCTGATCTTG
ATGGGGCGCTA -> TGGGGCGCTAG
CAAAGGGGGGT -> AAAGGGGGGTT
ACTCTTGTTGT -> CTCTTGTTGTA
ACCGATGCCTC -> CCGATGCCTCT
AACATTAGGGA -> ACATTAGGGAG
TGGATCATGGT -> GGATCATGGTC
GAACCCAAATA -> AACCCAAATAG
TAGGACACCTA -> AGGACACCTAT
CTGTATGATGT -> TGTATGATGTA
TCATTGGCCAT -> CATTGGCCATT
ATTAGAATGTC -> TTAGAATGTCT
TAGTAATTATT -> AGTAATTATTC
AAAGCATAAAT -> AAGCATAAATG
GTCTTTTCCCG -> TCTTTTCCCGG
TTAATGGGAGA -> TAATGGGAGAA
CAGTAGATTAC -> AGTAGATTACC
AGGTGAGACTG -> GGTGAGACTGC
GAATGTCTGGG -> AATGTCTGGGA
CTCGCTCGCTC -> TCGCTCGCTCA
AGCACCGCTCA -> GCACCGCTCAA
GTCTCTCCGCA -> TCTCTCCGCAC
ATAGTGTGCAC -> TAGTGTGCACC
AACCGCTAGTA -> ACCGCTAGTAA
ACACCTATCTC -> CACCTATCTCC
CCTTGAACAGG -> CTTGAACAGGG
CATGTTTACGT -> ATGTTTACGTC
TTCGGATTCGA -> TCGGATTCGAC
AGCACTAAAGG -> GCACTAAAGGG
GGTTTATAAAC -> GTTTATAAACC
GCTAGAAGGAA -> CTAGAAGGAAC
TCTAATCATGT -> CTAATCATGTC
GGCAGATTAAT -> GCAGATTAATG
GCACCAGTAGA -> CACCAGTAGAC
AATGAGGAAGT -> ATGAGGAAGTG
TTAGCACTAAA -> TAGCACTAAAG
GTAGATTACCT -> TAGATTACCTG
AGAGTAGCCCG -> GAGTAGCCCGG
TACGGGTTAGA -> ACGGGTTAGAA
AAAGGGGGGTT -> AAGGGGGGTTT
GCACCCAAAGG -> CACCCAAAGGG
ACAGAGTCTAC -> CAGAGTCTACC
AGGTAACCAAT -> GGTAACCAATT
CACAAATGGGG -> ACAAATGGGGC
GTGCAAGATCC -> TGCAAGATCCG
ACCAATTCGAT -> CCAATTCGATT
CCATTAGTAGT -> CATTAGTAGTG
AACCCTTAGGT -> ACCCTTAGGTA
GAATACACCAA -> AATACACCAAC
AATGGGAGAAG -> ATGGGAGAAGA
CGACCTCATTA -> GACCTCATTAT
TAACCCTTAGG -> AACCCTTAGGT
AGTTTTGCATT -> GTTTTGCATTG
ACCCCATACGT -> CCCCATACGTT
TGAGCTTTGGG -> GAGCTTTGGGT
TGCACCAGTAG -> GCACCAGTAGA
ACGACAGACTA -> CGACAGACTAG
GCTTAAACGTG -> CTTAAACGTGA
CGGTAAGAGTT -> GGTAAGAGTTA
GGGCAAGTTAG -> GGCAAGTTAGC
TCGATTCACTA -> CGATTCACTAC
TACTCGTGATG -> ACTCGTGATGT
ACCTTGCCTAA -> CCTTGCCTAAC
AGTATACTCGC -> GTATACTCGCT
ACTCTGTTTGC -> CTCTGTTTGCG
GTCGGGGCACC -> TCGGGGCACCC
AGGTAGCTCCT -> GGTAGCTCCTA
GTGTCACGGTG -> TGTCACGGTGA
TTCTACGCGCT -> TCTACGCGCTA
GTTCATTGGCC -> TTCATTGGCCA
CCCTTGGGGCG -> CCTTGGGGCGG
CCGTTAGGCCC -> CGTTAGGCCCG
GGAGTGACTAC -> GAGTGACTACT
GATTAGAATGT -> ATTAGAATGTC
ACTGGGGTTCT -> CTGGGGTTCTC
TGGATAATGAT -> GGATAATGATT
ATCTTCAAGGG -> TCTTCAAGGGA
TACGAGGCTTA -> ACGAGGCTTAA
ATCATGTCTAG -> TCATGTCTAGC
TAGGACCTTGC -> AGGACCTTGCC
TAGTATCCAAG -> AGTATCCAAGT
TAGCCCGGTTG -> AGCCCGGTTGC
TGAACATGAAG -> GAACATGAAGT
GGAATTTTCTA -> GAATTTTCTAA
AAGTCGTAAGA -> AGTCGTAAGAC
GAAGTAGGTGC -> AAGTAGGTGCC
CATCCCTTGAA -> ATCCCTTGAAC
GCTCCTAGTAT -> CTCCTAGTATC
AGCTTAGCTCA -> GCTTAGCTCAC
GACCAGCGTGT -> ACCAGCGTGTA
CCTGTTTCTCA -> CTGTTTCTCAC
AGCGATGAGTC -> GCGATGAGTCG
TCATCTTGACA -> CATCTTGACAC
TGTTTCTCACG -> GTTTCTCACGA
CCGAGGGCAGC -> CGAGGGCAGCT
AGTCTACCACC -> GTCTACCACCA
GGCCTGGAAGT -> GCCTGGAAGTA
CGCACACCCCA -> GCACACCCCAT
GGAAGTGTCAC -> GAAGTGTCACG
AAAGGGCAGTT -> AAGGGCAGTTT
TTGCAGCACCC -> TGCAGCACCCA
GTTGTAAGTGT -> TTGTAAGTGTC
GCACCGCTCAA -> CACCGCTCAAT
CCAGCTCCTAA -> CAGCTCCTAAA
ATCACGCGGGG -> TCACGCGGGGA
ATATGCGATTA -> TATGCGATTAA
GTGAATTAGTA -> TGAATTAGTAA
GGTCCGCCTGC -> GTCCGCCTGCA
GGGGCGCTAGA -> GGGCGCTAGAA
CTGCCATCCCT -> TGCCATCCCTT
CTAGCTTCTAT -> TAGCTTCTATG
CTATTAACCCT -> TATTAACCCTT
ATCGACCTCAT -> TCGACCTCATT
TCTTGTTGTAA -> CTTGTTGTAAG
ACATGTTAGGG -> CATGTTAGGGA
CGATTAACATA -> GATTAACATAC
GTGACAACATG -> TGACAACATGA
CCAACCATCGG -> CAACCATCGGA
TCGGTGCAGAG -> CGGTGCAGAGG
TTCCCGGCCAC -> TCCCGGCCACT
AACATGTTAGG -> ACATGTTAGGG
GCTGTGAGTCA -> CTGTGAGTCAA
CATAAAAGTCG -> ATAAAAGTCGT
AAAAGTCGTAA -> AAAGTCGTAAG
GTTTTTCTTAT -> TTTTTCTTATT
GAACAGGGAAT -> AACAGGGAATT
TTTATGTTAAA -> TTATGTTAAAA
AACCCAAATAG -> ACCCAAATAGT
CCAGCGTGTAA -> CAGCGTGTAAC
ATTAACCCTTA -> TTAACCCTTAG
TTGGCGAGCAT -> TGGCGAGCATA
CTTTCGAGCGG -> TTTCGAGCGGA
GTGACTACTGA -> TGACTACTGAC
AAGGGAGTACC -> AGGGAGTACCC
CACTACTCGTG -> ACTACTCGTGA
GGTCCGTTCAT -> GTCCGTTCATT
TCCCGGCCACT -> CCCGGCCACTC
GTGGAACATTA -> TGGAACATTAG
TGATGTTGGGA -> GATGTTGGGAT
CCGAAATTGCA -> CGAAATTGCAA
CCAGCAGGAAA -> CAGCAGGAAAG
CAAGGGAGTAC -> AAGGGAGTACC
TTAGGGAGGTG -> TAGGGAGGTGT,TAGGGAGGTGA
GGTGGAACATT -> GTGGAACATTA
CCCTCTCCCCA -> CCTCTCCCCAG
GGTGACTTACT -> GTGACTTACTT
CTTATGGTAGG -> TTATGGTAGGT
ACACCCTGATC -> CACCCTGATCT
GATTCGATTAG -> ATTCGATTAGA
CACTAAAGCCG -> ACTAAAGCCGT
TACTGACGCCG -> ACTGACGCCGG
GACACATCGTT -> ACACATCGTTT
TCTTTTCCCGG -> CTTTTCCCGGC
AGCATAAATGC -> GCATAAATGCA
GGATAGCGTAA -> GATAGCGTAAT
CTCTCGATCAC -> TCTCGATCACT
ATTATCCAGAT -> TTATCCAGATG
TGCCTCTAATC -> GCCTCTAATCA
TAGCTCACTCT -> AGCTCACTCTT
GCAACCGAAAT -> CAACCGAAATT
CAGTTCCTGAC -> AGTTCCTGACC
ATTCGCGCAGC -> TTCGCGCAGCA
GCACCTTGTCT -> CACCTTGTCTT
AGCTTTGGGTG -> GCTTTGGGTGA
GCGAGCATAGC -> CGAGCATAGCG
GGAACCGCCCG -> GAACCGCCCGG
TCCGAGGGCAG -> CCGAGGGCAGC
GTTATGACGAT -> TTATGACGATT
CAGGTACGGGT -> AGGTACGGGTT
GGTATAAAAAC -> GTATAAAAACC
TAACGAATATT -> AACGAATATTA
CTCCACATACA -> TCCACATACAA
TTCGATTAGAA -> TCGATTAGAAT
CACCAATGGAT -> ACCAATGGATA
ACTCGTGATGT -> CTCGTGATGTG
GTAAGACAAAC -> TAAGACAAACA
CCCGGGAGTGA -> CCGGGAGTGAC
AGCAGGAAAGC -> GCAGGAAAGCG
CCGCTAGTAAC -> CGCTAGTAACA
CCGGTAGGACC -> CGGTAGGACCT
AGTAGACAGTA -> GTAGACAGTAG
ACACCAACCAT -> CACCAACCATC
CCAAATAGTGT -> CAAATAGTGTG
GATCAGCCGAA -> ATCAGCCGAAA
ATTCCTCTGTG -> TTCCTCTGTGA
TAAAAGTCGTA -> AAAAGTCGTAA
ATTCCGGCGGA -> TTCCGGCGGAT
GTACGAGGTGT -> TACGAGGTGTG
CCACATACAAC -> CACATACAACC
GTGTCTCTCCG -> TGTCTCTCCGC
ACCGTAAACAT -> CCGTAAACATG
GTTAGGCCCGG -> TTAGGCCCGGG
GCCATCCCTTG -> CCATCCCTTGA
GTGATGTGCCC -> TGATGTGCCCG
TGTGAATTAGT -> GTGAATTAGTA
CAGCAGTTCCT -> AGCAGTTCCTG
TTCCGATATTC -> TCCGATATTCC
GACACCCTGAT -> ACACCCTGATC
CAAATAGTGTG -> AAATAGTGTGC
GAAAGCACCTT -> AAAGCACCTTG
CAGGGCTATGT -> AGGGCTATGTC
GTTAAAAGCAG -> TTAAAAGCAGG
GGACACCTATC -> GACACCTATCT
AGGACACGGCC -> GGACACGGCCA
TTTTCCCGGCC -> TTTCCCGGCCA
CTGTGCTAGTA -> TGTGCTAGTAG
ATATTACGGTT -> TATTACGGTTC
AGTACTCTTGT -> GTACTCTTGTT
ATGTTTTCCTT -> TGTTTTCCTTC
AACCCGAAGAG -> ACCCGAAGAGG
GCATAGCGGTC -> CATAGCGGTCA
ACGTTGAATTG -> CGTTGAATTGC
CAAAACCTGGT -> AAAACCTGGTT
CAAATGGGGCA -> AAATGGGGCAA
CGTTCATTGGC -> GTTCATTGGCC
TCCACATACAA -> CCACATACAAC
AGTAGGTGCCA -> GTAGGTGCCAT
TAGAAGGAACC -> AGAAGGAACCG
TCTTCCCTGCC -> CTTCCCTGCCG
TACGTCCAAAA -> ACGTCCAAAAC
CGGCGGATAGC -> GGCGGATAGCG
TGCCAGCAGGA -> GCCAGCAGGAA
GAGTCTACCAC -> AGTCTACCACC
TCTAATATGCG -> CTAATATGCGA
AGGAAGTGTCA -> GGAAGTGTCAC
AGTTTAACCAC -> GTTTAACCACA
CTGGGGTTCTC -> TGGGGTTCTCC
CGTGATCAGCC -> GTGATCAGCCG
CCTGCGTTGGC -> CTGCGTTGGCG
ACCAGGGTCTG -> CCAGGGTCTGC
AGAACCCAAAT -> GAACCCAAATA
AAATGAGGAAG -> AATGAGGAAGT
GTGACTGTGGA -> TGACTGTGGAG
TGTGAGTCAAA -> GTGAGTCAAAG
TCACGGTGACA -> CACGGTGACAA
TTTTGCATTGT -> TTTGCATTGTA
TAGGACGACAG -> AGGACGACAGA
TAGCTGTGAGT -> AGCTGTGAGTC
CTTCTACGCGC -> TTCTACGCGCT
TATGTCCATTA -> ATGTCCATTAA
GGGAATTTTCT -> GGAATTTTCTA
CACAGTTGCAG -> ACAGTTGCAGC
TAGGTGCCATT -> AGGTGCCATTA
CTGGGAGTTAT -> TGGGAGTTATG
TCTCCCCAGCT -> CTCCCCAGCTT
TCGTAAGACAA -> CGTAAGACAAA
TCTTAGTTTTG -> CTTAGTTTTGC
GACAGACCAGC -> ACAGACCAGCG
ATAAAAGTCGT -> TAAAAGTCGTA
GCAGGACACGG -> CAGGACACGGC
CTCAACTAGCT -> TCAACTAGCTG
CTATGTCCATT -> TATGTCCATTA
TACGTTGAATT -> ACGTTGAATTG
GTCACCTTTCG -> TCACCTTTCGA
ATGCCTACTGT -> TGCCTACTGTG
GAACCTTCTAC -> AACCTTCTACG
GTCTCGGGTGT -> TCTCGGGTGTC
ACCCTTGGGGC -> CCCTTGGGGCG
CTCTCCGCACA -> TCTCCGCACAC
TGAGGAAGTGT -> GAGGAAGTGTC
CGAAAGAACCC -> GAAAGAACCCA
TTGTGAATTAG -> TGTGAATTAGT
GTTCTCCGTAA -> TTCTCCGTAAT
TGACGCCGGTG -> GACGCCGGTGC
TTTCCTTCGGA -> TTCCTTCGGAT
CCAATGGATAA -> CAATGGATAAT
CCTAAACCTGA -> CTAAACCTGAG
GGGACTGCCAA -> GGACTGCCAAA
CGCCGGTGCGG -> GCCGGTGCGGC
GGGCTTAGGCA -> GGCTTAGGCAT
TCCTCGCACGA -> CCTCGCACGAA
ATTGCTGCTTC -> TTGCTGCTTCA
GAACATTAGGG -> AACATTAGGGA
GACGACAGACT -> ACGACAGACTA
GGTAGCTCCTA -> GTAGCTCCTAG
CAAGTCCGAGG -> AAGTCCGAGGG
GCGGTCCGTTC -> CGGTCCGTTCA
AGCATCGGATG -> GCATCGGATGT
TTGCGTACGAG -> TGCGTACGAGG
GGTGTGGTTCC -> GTGTGGTTCCA
ACAGACTAGCC -> CAGACTAGCCC
TGAAATGAGGA -> GAAATGAGGAA
CCATCGGATCG -> CATCGGATCGA
ACGAGCGTGAA -> CGAGCGTGAAA
GCTGGATCATG -> CTGGATCATGG
TTCTTCCCTGC -> TCTTCCCTGCC
AACGGTGACGG -> ACGGTGACGGA
TAACATACACT -> AACATACACTC
GGTGTCACAGC -> GTGTCACAGCA
CTCGGTGAGCT -> TCGGTGAGCTT
CAGCGGCGGCC -> AGCGGCGGCCC
AAAACCGAATG -> AAACCGAATGG
ACTACTCGTGA -> CTACTCGTGAT
TCTTGACACAA -> CTTGACACAAC
AGCGTAATTCA -> GCGTAATTCAG
CACATCGTTTT -> ACATCGTTTTT
TTCATTTATGT -> TCATTTATGTT
AATAGTGTGCA -> ATAGTGTGCAC
CGTAATCACGG -> GTAATCACGGT
TTTGGGAACGA -> TTGGGAACGAA
ACTAAACATCA -> CTAAACATCAC
ACCAACCATCG -> CCAACCATCGG
GTACGGGTTAG -> TACGGGTTAGA
CTCAGCGGTAA -> TCAGCGGTAAG
TATTCCCTCAG -> ATTCCCTCAGG
CTGATCTTGGC -> TGATCTTGGCA
CGAGCGGATAC -> GAGCGGATACC
AATCGCCCTTC -> ATCGCCCTTCG
ACCGAAAGCAC -> CCGAAAGCACC
TGTCTCTCCGC -> GTCTCTCCGCA
TCATGTCTAGC -> CATGTCTAGCT
CGATCACTAAA -> GATCACTAAAG
CAGTTTAACCA -> AGTTTAACCAC
GGCGGATAGCG -> GCGGATAGCGT
GAAGTGTCACG -> AAGTGTCACGG
ACAATTATTCG -> CAATTATTCGC
TGATATCACGC -> GATATCACGCG
TCAATAGATGA -> CAATAGATGAT
ATGAAGAACCT -> TGAAGAACCTT
AGGCATGAGAT -> GGCATGAGATC
GTGTGCACCAG -> TGTGCACCAGT
CCGGTTGCCCA -> CGGTTGCCCAC
CGTTTTTCTTA -> GTTTTTCTTAT
AATACACCAAC -> ATACACCAACC
TCACCTTTCGA -> CACCTTTCGAC
GACGATTGTGA -> ACGATTGTGAA
TTTCGAGCGGA -> TTCGAGCGGAT
CCCTTAGGTAG -> CCTTAGGTAGC
GTCCTGACGCC -> TCCTGACGCCT
TAGGTAGCTCC -> AGGTAGCTCCT
TCCGGCGGATA -> CCGGCGGATAG
AAACATGTTTT -> AACATGTTTTC
GTAACAATTAT -> TAACAATTATT
CCGTGATCAGC -> CGTGATCAGCC
CTACTGACGCC -> TACTGACGCCG
GGACAGACCAG -> GACAGACCAGC
AGCGTGTAACG -> GCGTGTAACGA
ACGTGACGTGC -> CGTGACGTGCA
TCATTTATGTT -> CATTTATGTTA
CCTGCTAGCAA -> CTGCTAGCAAC
GCTAGTAGTAT -> CTAGTAGTATA
GGCTGGATCAT -> GCTGGATCATG
CGGATCGACCT -> GGATCGACCTC
ATACACTCAGC -> TACACTCAGCG
CTGCCAAAACC -> TGCCAAAACCT
CGGGAGTGACT -> GGGAGTGACTA
GACTAGCCCAC -> ACTAGCCCACT
AATGAATACAC -> ATGAATACACC
TCGCCCTTCGC -> CGCCCTTCGCG
GCGTGTAACGA -> CGTGTAACGAA
TGCAGGACACG -> GCAGGACACGG
TGGTAGGTCCG -> GGTAGGTCCGC
GGTCACCTTTC -> GTCACCTTTCG
GATGATCAGCG -> ATGATCAGCGG
TCTCACGAGAA -> CTCACGAGAAT
GTCACGGTGAC -> TCACGGTGACA
GACACCTATCT -> ACACCTATCTC
CTGACCGAAAG -> TGACCGAAAGC
GTATGATGTAA -> TATGATGTAAA
AAGAACGACCA -> AGAACGACCAT
GCTCACTCTTT -> CTCACTCTTTC
TTTAACCACAG -> TTAACCACAGT
TGCTAGCAACC -> GCTAGCAACCG
TGACAACATGA -> GACAACATGAC
CGAATATTACG -> GAATATTACGG
GGTAGGTCCGC -> GTAGGTCCGCC
AGAACGACCAT -> GAACGACCATG
TGGGAGAAGAA -> GGGAGAAGAAC
CGGTGACGGAT -> GGTGACGGATT
CAGCTTAGCTC -> AGCTTAGCTCA
TTGGGATTTCC -> TGGGATTTCCT
TTTTCTTATTC -> TTTCTTATTCA
TTCGCGCTATT -> TCGCGCTATTA
CTAAACCTGAG -> TAAACCTGAGC
CCTGACGCCTC -> CTGACGCCTCC
CGATGAGTCGG -> GATGAGTCGGG
TACCTGCTAGC -> ACCTGCTAGCA
CATACAACCCT -> ATACAACCCTT
AAAGTCGTAAG -> AAGTCGTAAGA
CGCAGTCGACA -> GCAGTCGACAC
TCGGTGAGCTT -> CGGTGAGCTTT
GATAGCGTAAT -> ATAGCGTAATT
TAGCCTGCGCG -> AGCCTGCGCGG
CTACGAGGCTT -> TACGAGGCTTA
GGCTTAAACGT -> GCTTAAACGTG
CGCGCAGTCGA -> GCGCAGTCGAC
CCTCTCCCCAG -> CTCTCCCCAGC
CGGATGTAGGA -> GGATGTAGGAG
AGGCTTAAACG -> GGCTTAAACGT
GAGCATAGCGG -> AGCATAGCGGT
TGCCTACTGTG -> GCCTACTGTGC
AAAGCAGGTAC -> AAGCAGGTACG
AAAGCCGTTAG -> AAGCCGTTAGG
TAGTAGTATAC -> AGTAGTATACT
AAAGAACCCAA -> AAGAACCCAAA
TTGCCCACCAG -> TGCCCACCAGG
GTCACAGCAGT -> TCACAGCAGTT
GCACACCCCAT -> CACACCCCATA
CGGTGCGGCAG -> GGTGCGGCAGA
ATTCGACGGAC -> TTCGACGGACA
CTAATCATGTC -> TAATCATGTCT
ACGTCCAAAAC -> CGTCCAAAACT
ATTGTATTGCG -> TTGTATTGCGA
GTGTAACGAAT -> TGTAACGAATA
CGTAGGACACC -> GTAGGACACCT
GGCAATATTCC -> GCAATATTCCT
GGAAGTAGGTG -> GAAGTAGGTGC
CGCTAGTAACA -> GCTAGTAACAA
GGGTCTGCCTC -> GGTCTGCCTCG
TAGTAACAATT -> AGTAACAATTA
GGATTTGGCCA -> GATTTGGCCAT
TACACCAACCA -> ACACCAACCAT
CTTGAACAGGG -> TTGAACAGGGA
GGGTGGAACAT -> GGTGGAACATT
GACTGCCAAAA -> ACTGCCAAAAC
CAAAGCATAAA -> AAAGCATAAAT
TGACTACGAGG -> GACTACGAGGC
TGCTTCAATAG -> GCTTCAATAGA
GCATGAGATCC -> CATGAGATCCC
CTGTGAGTCAA -> TGTGAGTCAAA
TCCGGGGAGTC -> CCGGGGAGTCC
CGTTCATTTAT -> GTTCATTTATG
GGCTTAGGCAT -> GCTTAGGCATG
AACCGCCCGGT -> ACCGCCCGGTA
GCTATTAACCC -> CTATTAACCCT
AACAGGGAATT -> ACAGGGAATTT
TCTGTGAGGAC -> CTGTGAGGACC
GAGTCGGGGCA -> AGTCGGGGCAC
GCTAGCAACCG -> CTAGCAACCGA
GTGACGTGCAA -> TGACGTGCAAG
GAGTACCCTGC -> AGTACCCTGCG
AACATGACCGT -> ACATGACCGTA
TGTGCCCGTGA -> GTGCCCGTGAT
TGCCGCGGCAA -> GCCGCGGCAAT
CGCCTCCACAT -> GCCTCCACATA
TTCCTTCGGAT -> TCCTTCGGATT
GTCCTCGTGAA -> TCCTCGTGAAC
ATGATTACGAG -> TGATTACGAGC
CTCTGTTTGCG -> TCTGTTTGCGT
GTAGGACACCT -> TAGGACACCTA
ATTAATGGGAG -> TTAATGGGAGA
AGGACCCTGGC -> GGACCCTGGCC
TTGCCTAACAA -> TGCCTAACAAT
ACCTATCTCCA -> CCTATCTCCAG
TCGACCTCATT -> CGACCTCATTA
GACGTGCAAGA -> ACGTGCAAGAT
TAGTTTTGCAT -> AGTTTTGCATT
AGTATCCAAGT -> GTATCCAAGTA
GCCTCTAATCA -> CCTCTAATCAT
GAACCCGAAGA -> AACCCGAAGAG
CACATACAACC -> ACATACAACCC
GGTGAGCTTTG -> GTGAGCTTTGG
CGACAGACTAG -> GACAGACTAGC
GGGAACGAAAG -> GGAACGAAAGA
TTAACCACAGT -> TAACCACAGTT
GAATATTACGG -> AATATTACGGT
CCTCTAATCAT -> CTCTAATCATG
GAACCGCCCGG -> AACCGCCCGGT
AACATGTTTTC -> ACATGTTTTCC
CATGACCGTAA -> ATGACCGTAAA
TTGGGGCGGTC -> TGGGGCGGTCC
CAATTATTCGC -> AATTATTCGCG
GTTTGCGTACG -> TTTGCGTACGA
TCAGGTAACCA -> CAGGTAACCAA
CGGTTCGGTGC -> GGTTCGGTGCA
GCATTGTATTG -> CATTGTATTGC
CCTCTAGGACG -> CTCTAGGACGA
TAAATGCAGGA -> AAATGCAGGAC
TGTTAGGGAGG -> GTTAGGGAGGT
AATGTCTGGGA -> ATGTCTGGGAG
AATGAAGAACC -> ATGAAGAACCT
GAGAAGAACGA -> AGAAGAACGAC
TAAGACAAACA -> AAGACAAACAT
ATGTCTAGCTT -> TGTCTAGCTTC
AGTCGTAAGAC -> GTCGTAAGACA
GGTCGGTCTTA -> GTCGGTCTTAG
ATGCCTCTAAT -> TGCCTCTAATC
AATGATGCCAG -> ATGATGCCAGC
TGTCACGGTGA -> GTCACGGTGAC
GGGGCGGTCCG -> GGGCGGTCCGT
GGCAAGTTAGC -> GCAAGTTAGCC
AACCCTCTCCC -> ACCCTCTCCCC
ATGCATAAAAG -> TGCATAAAAGT
TGAAGTTCACG -> GAAGTTCACGC
GGTTAGAACTC -> GTTAGAACTCT
CTTCGGATTCG -> TTCGGATTCGA
ATGGTCGGTCT -> TGGTCGGTCTT
CTCGGGTGTCA -> TCGGGTGTCAC
GGTCTTAGCAC -> GTCTTAGCACT
CGAGGCTTAAA -> GAGGCTTAAAC
TCGGGTGTCAC -> CGGGTGTCACA
CTCAGGTAACC -> TCAGGTAACCA
GGCCCTCCTCT -> GCCCTCCTCTA
ATTCACTACTC -> TTCACTACTCG
AGAAACAGAGT -> GAAACAGAGTC
CTTAGGTAGCT -> TTAGGTAGCTC
CCTTCGCGCTA -> CTTCGCGCTAT
CGGTAGGACCT -> GGTAGGACCTT
GGTGACGGATT -> GTGACGGATTT
GGACTGCCAAA -> GACTGCCAAAA
ATTCAGGTCAT -> TTCAGGTCATC
ATGATGCCAGC -> TGATGCCAGCA
ACGACCATGTT -> CGACCATGTTT
AGGGCAGTTTA -> GGGCAGTTTAA
CAATCGCCCTT -> AATCGCCCTTC
GACACAACGGT -> ACACAACGGTG
GCGGATAGCGT -> CGGATAGCGTA
TGTAACGAATA -> GTAACGAATAT
CGGCGGCCCTC -> GGCGGCCCTCC
CGAACCCGAAG -> GAACCCGAAGA
ATGGGAGAAGA -> TGGGAGAAGAA
CCAGATGCATA -> CAGATGCATAA
GGACCTTGCCT -> GACCTTGCCTA
TACGAGCGTGA -> ACGAGCGTGAA
AGTCGACACCC -> GTCGACACCCT
ATCCCGTGACT -> TCCCGTGACTA
GAGATCCCGTG -> AGATCCCGTGA
AACAATTATTC -> ACAATTATTCG
TTCACGCGCAG -> TCACGCGCAGT
CCCGTGATCAG -> CCGTGATCAGC
GAACGAAAGAA -> AACGAAAGAAC
CCGAAAGCACC -> CGAAAGCACCT
CACCCTGATCT -> ACCCTGATCTT
GATTGTGAATT -> ATTGTGAATTA
CTCGTGATGTG -> TCGTGATGTGC
TCATCATCTTG -> CATCATCTTGA
CGGCAATATTC -> GGCAATATTCC
CGGTGCAGAGG -> GGTGCAGAGGT
ACGGATTTGGC -> CGGATTTGGCC
TTAAACGTGAC -> TAAACGTGACG
ATCCAAGTACT -> TCCAAGTACTC
GACTTACTTAT -> ACTTACTTATG
GGAGTCCTGAC -> GAGTCCTGACG
CTGGATCATGG -> TGGATCATGGT
ATCCGGGGAGT -> TCCGGGGAGTC
AGATCCGGGGA -> GATCCGGGGAG
CCTACTGTGCT -> CTACTGTGCTA
AGTACCCTGCG -> GTACCCTGCGT
GTGGAGCATCG -> TGGAGCATCGG
GCGTTGGCGAG -> CGTTGGCGAGC
GAAATGAGGAA -> AAATGAGGAAG
AACGTGACGTG -> ACGTGACGTGC
TAGGCATGAGA -> AGGCATGAGAT
TCCAAAACTAA -> CCAAAACTAAA
CTCCTAAACCT -> TCCTAAACCTG
CAAGATCCGGG -> AAGATCCGGGG
GGCGGCCCTCC -> GCGGCCCTCCT
CTCAATCGCCC -> TCAATCGCCCT
GATCTTGGCAG -> ATCTTGGCAGA
CCATTGCTGCT -> CATTGCTGCTT
TCGGATGTAGG -> CGGATGTAGGA
GCCTAACAATG -> CCTAACAATGA
GTAAACATGTT -> TAAACATGTTA
CCAGGGCTATG -> CAGGGCTATGT
CACAACGGTGA -> ACAACGGTGAC
GGATAATGATT -> GATAATGATTC
CGCCTGCAGAA -> GCCTGCAGAAA
CAGAGTAGCCC -> AGAGTAGCCCG
GTAACCAATTC -> TAACCAATTCG
ATAAGGCTGGA -> TAAGGCTGGAT
AATATTACGGT -> ATATTACGGTT
TGTCACAGCAG -> GTCACAGCAGT
GGTGCCATTAA -> GTGCCATTAAA
CTGTGAGGACC -> TGTGAGGACCC
CGGATACCGAT -> GGATACCGATG
ATTCGATTCAC -> TTCGATTCACT
CGTAAACATGT -> GTAAACATGTT
ATGATGTAAAA -> TGATGTAAAAC
AGCAACCGAAA -> GCAACCGAAAT
CCTCATTATCC -> CTCATTATCCA
TAAACATGTTA -> AAACATGTTAG
CGTGACTACGA -> GTGACTACGAG
ACGCGCTATCA -> CGCGCTATCAA
CACGGTGACAA -> ACGGTGACAAC
TTCAAGGGAGT -> TCAAGGGAGTA
CCGCCTGCAGA -> CGCCTGCAGAA
TCCAAAGCATA -> CCAAAGCATAA
CTGCGTTGGCG -> TGCGTTGGCGA
AGTTTACGTGG -> GTTTACGTGGC
TGAAGAACCTT -> GAAGAACCTTC
CTGCCTCGTAG -> TGCCTCGTAGG
GCAGTCGACAC -> CAGTCGACACC
TCTTCTTCCCT -> CTTCTTCCCTG
GGTTCGGTGCA -> GTTCGGTGCAG
AAGTGTCTCTC -> AGTGTCTCTCC
CTATGATTACG -> TATGATTACGA
ACCCGAAGAGG -> CCCGAAGAGGG
TTGATATCACG -> TGATATCACGC
AGCTAGTCCTC -> GCTAGTCCTCG
ATGAGTCGGGG -> TGAGTCGGGGC
CAGTTGCAGCA -> AGTTGCAGCAC
CACACCCCATA -> ACACCCCATAC
TGACCGAAAGC -> GACCGAAAGCA
TTCCCTCAGGT -> TCCCTCAGGTA
TCAGTCTCGGG -> CAGTCTCGGGT
AACCAATTCGA -> ACCAATTCGAT
GCTGATGTTGG -> CTGATGTTGGG
AGAGGTGGGCT -> GAGGTGGGCTT
TAGCTCCTAGT -> AGCTCCTAGTA
CGCAGCAGTGT -> GCAGCAGTGTG
CGGGGAGTCCT -> GGGGAGTCCTG
AGGACACCTAT -> GGACACCTATC
CCAAAGCATAA -> CAAAGCATAAA
TTCTCCGTAAT -> TCTCCGTAATC
AAGCCGTTAGG -> AGCCGTTAGGC
ATGTTTACGTC -> TGTTTACGTCC
GTCCAAAACTA -> TCCAAAACTAA
ATTTGGCCATT -> TTTGGCCATTG
GGTGAGACTGC -> GTGAGACTGCC
AACATACACTC -> ACATACACTCA
TAGCTTCTATG -> AGCTTCTATGA
CCTGACCGAAA -> CTGACCGAAAG
CCGCACACCCC -> CGCACACCCCA
ATCAATAAGGC -> TCAATAAGGCT
CCACTCTGTTT -> CACTCTGTTTG
ATGAGGAAGTG -> TGAGGAAGTGT
TGATGCCAGCA -> GATGCCAGCAG
TGCCCGTGATC -> GCCCGTGATCA
TTTTCCTTCGG -> TTTCCTTCGGA
AACCTGAGCTG -> ACCTGAGCTGA
CTCACTCTTTC -> TCACTCTTTCG
ATTTATGTTAA -> TTTATGTTAAA
TTCCGGCGGAT -> TCCGGCGGATA
AGCCCACTGGG -> GCCCACTGGGG
CAATAGATGAT -> AATAGATGATC
GCGGTCACCTT -> CGGTCACCTTT
CTAGCAACCGA -> TAGCAACCGAA
GAATTTTCTAA -> AATTTTCTAAT
ATGGATAATGA -> TGGATAATGAT
GTGTCACAGCA -> TGTCACAGCAG
CTGGTTCCGAT -> TGGTTCCGATA
TCCAGCTCCTA -> CCAGCTCCTAA
CTTCTTCCCTG -> TTCTTCCCTGC
TCTGTTTGCGT -> CTGTTTGCGTA
CTTCGCGCTAT -> TTCGCGCTATT
CGCGCAGCAGT -> GCGCAGCAGTG
TATCCAAGTAC -> ATCCAAGTACT
TTCGACACATC -> TCGACACATCG
CCCATACGTTG -> CCATACGTTGA
TATTCCTCTGT -> ATTCCTCTGTG
CAATCTTAGTT -> AATCTTAGTTT
TAATATGCGAT -> AATATGCGATT
CATGAAGTTCA -> ATGAAGTTCAC
CGGTATAAAAA -> GGTATAAAAAC
GGCAGTTTAAC -> GCAGTTTAACC
TGATTCGATTA -> GATTCGATTAG
GTGTGGTTCCA -> TGTGGTTCCAT
AGAAGGAACCG -> GAAGGAACCGC
CACCAGTAGAC -> ACCAGTAGACA
CTGGCCTTGAT -> TGGCCTTGATA
CCACCAATGGA -> CACCAATGGAT
TTAGTTTTGCA -> TAGTTTTGCAT
TGTCTTTTCCC -> GTCTTTTCCCG
CGTAAGACAAA -> GTAAGACAAAC
TCACGCGCAGT -> CACGCGCAGTC
CTAGTAGTATA -> TAGTAGTATAC
CTTTTCCCGGC -> TTTTCCCGGCC
ATTGCGAACCC -> TTGCGAACCCG
GTGGAAATATC -> TGGAAATATCT
GGCAGAGTAGC -> GCAGAGTAGCC
ACCGAATGGGG -> CCGAATGGGGC
AACATGAAGTT -> ACATGAAGTTC
CTTAGTTTTGC -> TTAGTTTTGCA
GTAAGAGTTAC -> TAAGAGTTACC
CCTGGTTCCGA -> CTGGTTCCGAT
ACCTCATTATC -> CCTCATTATCC
TTAGAATGTCT -> TAGAATGTCTG
GCGATTAACAT -> CGATTAACATA
CGGCCAGGGCT -> GGCCAGGGCTA
TCACGAGAATG -> CACGAGAATGA
TTATGACGATT -> TATGACGATTG
AAGCACCTTGT -> AGCACCTTGTC
AAGACAAACAT -> AGACAAACATG
ACAACCCTTGG -> CAACCCTTGGG
TAGGAGTGGAA -> AGGAGTGGAAA
TCTTCAAGGGA -> CTTCAAGGGAG
GATTCGACGGA -> ATTCGACGGAC
CACGCGGGGAC -> ACGCGGGGACT
CCTTGATATCA -> CTTGATATCAC
AGTAGTGCCTG -> GTAGTGCCTGT
ATGATTCGATT -> TGATTCGATTA
GCGGATACCGA -> CGGATACCGAT
TTAAAGCACCG -> TAAAGCACCGC
CCGCGGCAATA -> CGCGGCAATAT
GTTCCATTAGT -> TTCCATTAGTA
CTTAGGCATGA -> TTAGGCATGAG
CTCTTGTTGTA -> TCTTGTTGTAA
ACGCCTCCACA -> CGCCTCCACAT
CACGAATGAAT -> ACGAATGAATA
ATGAAGTTCAC -> TGAAGTTCACG
CTATCAATAAG -> TATCAATAAGG
GAGCGGATACC -> AGCGGATACCG
GTGCTAGTAGT -> TGCTAGTAGTA
CCAGTAGACAG -> CAGTAGACAGT
ACGGCCAGGGC -> CGGCCAGGGCT
ACAAACATGTT -> CAAACATGTTT
ACGAGAATGAT -> CGAGAATGATG
CCCTGGCCTTG -> CCTGGCCTTGA
GGATCATGGTC -> GATCATGGTCG
AGGGTGGAACA -> GGGTGGAACAT
TGAGGACCCTG -> GAGGACCCTGG
TAAAGCACCGC -> AAAGCACCGCT
CATCACAAATG -> ATCACAAATGG
ATCGGATGTAG -> TCGGATGTAGG
AAAGCACCGCT -> AAGCACCGCTC
AATAAGGCTGG -> ATAAGGCTGGA
ATCGTTTTTCT -> TCGTTTTTCTT
AAACGTGACGT -> AACGTGACGTG
CTTCCCTGCCG -> TTCCCTGCCGC
GGGAGGTGAGA -> GGAGGTGAGAC
CCTGGAAGTAG -> CTGGAAGTAGG
CAACGGTGACG -> AACGGTGACGG
TGGTTCCATTA -> GGTTCCATTAG
GGAGTACCCTG -> GAGTACCCTGC
AGGGCTATGTC -> GGGCTATGTCC
GAATTAGTAAT -> AATTAGTAATT
TTACTTATGGT -> TACTTATGGTA
CCGGTGCGGCA -> CGGTGCGGCAG
ACTAGCTGTGA -> CTAGCTGTGAG
GAGCATCGGAT -> AGCATCGGATG
AGTGGAAATAT -> GTGGAAATATC
TGACGTGCAAG -> GACGTGCAAGA
CGCTCAACTAG -> GCTCAACTAGC
ATCTTAGTTTT -> TCTTAGTTTTG
ACACATCGTTT -> CACATCGTTTT
AATTGCAATCT -> ATTGCAATCTT
TATGGTAGGTC -> ATGGTAGGTCC
TGTGCTAGTAG -> GTGCTAGTAGT
CCAGCTTAGCT -> CAGCTTAGCTC
GCAGTTCCTGA -> CAGTTCCTGAC
ACAGTTGCAGC -> CAGTTGCAGCA
GGCGGTCCGTT -> GCGGTCCGTTC
GATAATGATTC -> ATAATGATTCG
TGGTCGGTCTT -> GGTCGGTCTTA
CGAAGAGGGTG -> GAAGAGGGTGG
GGCAGCTAGTC -> GCAGCTAGTCC
GAAACAGAGTC -> AAACAGAGTCT
CACTCTTTCGA -> ACTCTTTCGAG
TCACGGTATAA -> CACGGTATAAA
GGCCATTGCTG -> GCCATTGCTGC
CGATGCCTCTA -> GATGCCTCTAA
AGCGGTCACCT -> GCGGTCACCTT
GTAAGTGTCTC -> TAAGTGTCTCT
TAGTATACTCG -> AGTATACTCGC
GTAAAACCGAA -> TAAAACCGAAT
GCAGGAAAGCG -> CAGGAAAGCGA
GGAGGTGTGGT -> GAGGTGTGGTT
CATTGTATTGC -> ATTGTATTGCG
GCCATTAAAGC -> CCATTAAAGCA
CGGTCTTAGCA -> GGTCTTAGCAC
CCCTGCGTTGG -> CCTGCGTTGGC
TGTTTGCGTAC -> GTTTGCGTACG
AACTAAACATC -> ACTAAACATCA
TCGGGGCACCC -> CGGGGCACCCA
CTACTGTGCTA -> TACTGTGCTAG
ACGTGCAAGAT -> CGTGCAAGATC
GTAGGTGCCAT -> TAGGTGCCATT
AAGGAACCGCC -> AGGAACCGCCC
ACGATTGTGAA -> CGATTGTGAAT
TAGCACTAAAG -> AGCACTAAAGG
AACATCACAAA -> ACATCACAAAT
TGCCAAAACCT -> GCCAAAACCTG
AGGGCAGCTAG -> GGGCAGCTAGT
GGTCATCATCT -> GTCATCATCTT
CCTTAGGTAGC -> CTTAGGTAGCT
TCAGGTCATCA -> CAGGTCATCAT
GCAGTTTAACC -> CAGTTTAACCA
AGGTGCCATTA -> GGTGCCATTAA
TTGTCTTTTCC -> TGTCTTTTCCC
TCTACGCGCTA -> CTACGCGCTAT
GGTTTCCACTC -> GTTTCCACTCG
TGACACAACGG -> GACACAACGGT
CTACGCGCTAT -> TACGCGCTATC
GGATCCTCGCA -> GATCCTCGCAC
GTTCCTGACCG -> TTCCTGACCGA
AAACCGAATGG -> AACCGAATGGG
ACCGCTCAATC -> CCGCTCAATCG
TAAACGTGACG -> AAACGTGACGT
CGCGGTTTATA -> GCGGTTTATAA
TACTTATGGTA -> ACTTATGGTAG
TGAATTGCAAT -> GAATTGCAATC
ACGAGGTGTGC -> CGAGGTGTGCC
TGTCTAGCTTC -> GTCTAGCTTCT
TATGCGATTAA -> ATGCGATTAAC
GAAGTTCACGC -> AAGTTCACGCG
CAGAAACAGAG -> AGAAACAGAGT
AGGTGGGCTTA -> GGTGGGCTTAG
ACCCTCTCCCC -> CCCTCTCCCCA
AGTGACTACTG -> GTGACTACTGA
CGGTGAGCTTT -> GGTGAGCTTTG
GTGACTACGAG -> TGACTACGAGG
GGACCCTGGCC -> GACCCTGGCCT
CTCCTCTAGGA -> TCCTCTAGGAC
CCTGCAGAAAC -> CTGCAGAAACA
GCGGCAATATT -> CGGCAATATTC
TTCGATTCACT -> TCGATTCACTA
CAGATTAATGG -> AGATTAATGGG
AGGCCCGGGAG -> GGCCCGGGAGT
GCCTTGATATC -> CCTTGATATCA
GTCGACACCCT -> TCGACACCCTG
ACATCGTTTTT -> CATCGTTTTTC
GGTTCCGATAT -> GTTCCGATATT
TTCCTCTGTGA -> TCCTCTGTGAG
ATGTCTGGGAG -> TGTCTGGGAGT
CCGAATGGGGC -> CGAATGGGGCG
CAGATGCATAA -> AGATGCATAAA
TATCTTCAAGG -> ATCTTCAAGGG
GGGCTATGTCC -> GGCTATGTCCA
GTCATCATCTT -> TCATCATCTTG
AATCACGGTAT -> ATCACGGTATA
CAATAAGGCTG -> AATAAGGCTGG
ATGCGATTAAC -> TGCGATTAACA
GTTTTGCATTG -> TTTTGCATTGT
AGACCAGCGTG -> GACCAGCGTGT
ATTGTGAATTA -> TTGTGAATTAG
GCTAGTCCTCG -> CTAGTCCTCGT
GATGTAAAACC -> ATGTAAAACCG
GTTTACGTCCA -> TTTACGTCCAA
TCACTACTCGT -> CACTACTCGTG
CGCTAGAAGGA -> GCTAGAAGGAA
TACGAGGTGTG -> ACGAGGTGTGC
ATCGCCCTTCG -> TCGCCCTTCGC
CACCTTTCGAC -> ACCTTTCGACA
GACGCCTCCAC -> ACGCCTCCACA
TAAAACCGAAT -> AAAACCGAATG
CGGGTTAGAAC -> GGGTTAGAACT
TGCAGCACCCA -> GCAGCACCCAT
AGGGAGGTGTG -> GGGAGGTGTGG
TTGTAAGTGTC -> TGTAAGTGTCT
TGGAAGTAGGT -> GGAAGTAGGTG
AAACCGCTAGT -> AACCGCTAGTA
GGGCAGCTAGT -> GGCAGCTAGTC
TAATGGGAGAA -> AATGGGAGAAG
CATAGCGGTCA -> ATAGCGGTCAC
GAACGACCATG -> AACGACCATGT
ACTAGCCCACT -> CTAGCCCACTG
TGTGGTTCCAT -> GTGGTTCCATT
AACGAATATTA -> ACGAATATTAC
ATCGGATCGAC -> TCGGATCGACC
TGTAGGAGTGG -> GTAGGAGTGGA
GAGTTACCTTT -> AGTTACCTTTA
CACCTATCTCC -> ACCTATCTCCA
TCCATTAGTAG -> CCATTAGTAGT
CCCACTGGGGT -> CCACTGGGGTT
TCCCGTGACTA -> CCCGTGACTAC
TCGATTAGAAT -> CGATTAGAATG
GTGAGCTTTGG -> TGAGCTTTGGG
AAAACCCTCTC -> AAACCCTCTCC
TACCCTGCGTT -> ACCCTGCGTTG
ATGATCAGCGG -> TGATCAGCGGC
ACTGCCAAAAC -> CTGCCAAAACC
AAACCTGAGCT -> AACCTGAGCTG
GCCGGTGCGGC -> CCGGTGCGGCA
CGAGAATGATG -> GAGAATGATGC
TCGGATTCGAC -> CGGATTCGACG
ACTGTGCTAGT -> CTGTGCTAGTA
TTTTTGGGAAC -> TTTTGGGAACG
ATAAACCGCTA -> TAAACCGCTAG
ATACGTTGAAT -> TACGTTGAATT
TAATTCAGGTC -> AATTCAGGTCA
ATGTTGGGATT -> TGTTGGGATTT
AAGAAGTTTAC -> AGAAGTTTACG
CTTATTCAGTC -> TTATTCAGTCT
TTTATAAACCG -> TTATAAACCGC
GCCCTTCGCGC -> CCCTTCGCGCT
ATTTTCCAAAG -> TTTTCCAAAGC
TACGTGGCCTG -> ACGTGGCCTGG
GCCTCCACATA -> CCTCCACATAC
ATTGCAATCTT -> TTGCAATCTTA
AGAAGAACGAC -> GAAGAACGACC
CCATTAAAGCA -> CATTAAAGCAC
GTATACTCGCT -> TATACTCGCTC
TTCGGTGCAGA -> TCGGTGCAGAG
TGACTACTGAC -> GACTACTGACG
TGAATTAGTAA -> GAATTAGTAAT
TGCGTTGGCGA -> GCGTTGGCGAG
AACCATCGGAT -> ACCATCGGATC
TTTACGTGGCC -> TTACGTGGCCT
TCCCTTGAACA -> CCCTTGAACAG
GCCCGGTAGGA -> CCCGGTAGGAC
TCCAGATGCAT -> CCAGATGCATA
CCTAACAATGA -> CTAACAATGAA
TCGTTCATTTA -> CGTTCATTTAT
TGGAACATTAG -> GGAACATTAGG
TGGAAATATCT -> GGAAATATCTT
TGCAGAGGTGG -> GCAGAGGTGGG
TCTCCGCACAC -> CTCCGCACACC
ACATGTTTTCC -> CATGTTTTCCT
ACGAATATTAC -> CGAATATTACG
ATCCTCGCACG -> TCCTCGCACGA
TATGACGATTG -> ATGACGATTGT
AGTTGCAGCAC -> GTTGCAGCACC
CACCCAAAGGG -> ACCCAAAGGGG
CACTCGGTGAG -> ACTCGGTGAGC
AAAGAAGTTTA -> AAGAAGTTTAC
GATTTCCTGTA -> ATTTCCTGTAT
AGGACGACAGA -> GGACGACAGAC
TCGCGCTATTA -> CGCGCTATTAA
AAATGGGGCAA -> AATGGGGCAAG
GCCCGGTTGCC -> CCCGGTTGCCC
GCAATCTTAGT -> CAATCTTAGTT
TTACGTCCAAA -> TACGTCCAAAA
CCGATATTCCG -> CGATATTCCGG
TTTACGTCCAA -> TTACGTCCAAA
ATAATGATTCG -> TAATGATTCGA
ATCACTAAAGC -> TCACTAAAGCC
AGCTCACTCTT -> GCTCACTCTTT
TACACTCAGCG -> ACACTCAGCGG
AGTCAAAGAAG -> GTCAAAGAAGT
TTATTCAGTCT -> TATTCAGTCTC
GATATTCCGGC -> ATATTCCGGCG
GAGAATGATGC -> AGAATGATGCC
GTGTGACTGTG -> TGTGACTGTGG
GGCCAGGGCTA -> GCCAGGGCTAT
CACTCAGCGGT -> ACTCAGCGGTA
CAGACCAGCGT -> AGACCAGCGTG
GCCAAAACCTG -> CCAAAACCTGG
CAGCTCCTAAA -> AGCTCCTAAAC
GTGAGACTGCC -> TGAGACTGCCA
AGGGAGTACCC -> GGGAGTACCCT
GGCACCCAAAG -> GCACCCAAAGG
CAATGAAGAAC -> AATGAAGAACC
CCCATGCCTAC -> CCATGCCTACT
CTCTAGGACGA -> TCTAGGACGAC
GTTGCAGCACC -> TTGCAGCACCC
AAATATCTTCA -> AATATCTTCAA
TATTCCGGCGG -> ATTCCGGCGGA
CGCTATTAACC -> GCTATTAACCC
GCCAGCAGGAA -> CCAGCAGGAAA
GCAATATTCCT -> CAATATTCCTC
TTTGGGTGACT -> TTGGGTGACTT
CAGCGGTAAGA -> AGCGGTAAGAG
TAGCGTAATTC -> AGCGTAATTCA
GAGGAAGTGTC -> AGGAAGTGTCA
GTCGGTCTTAG -> TCGGTCTTAGC
ACCTTCTACGC -> CCTTCTACGCG
TTGAATTGCAA -> TGAATTGCAAT
TGTATTGCGAA -> GTATTGCGAAC
CGACACATCGT -> GACACATCGTT
CATTGGCCATT -> ATTGGCCATTT
ACGGTATAAAA -> CGGTATAAAAA
GGGTGACTTAC -> GGTGACTTACT
AGCAGTGTGAC -> GCAGTGTGACT
CCACAGTTGCA -> CACAGTTGCAG
TCAGCGGTAAG -> CAGCGGTAAGA
TGCCTCGTAGG -> GCCTCGTAGGA
GTGCACCAGTA -> TGCACCAGTAG
TTTGCGTACGA -> TTGCGTACGAG
GCATAAAAGTC -> CATAAAAGTCG
ATTGCAAGTCC -> TTGCAAGTCCG
TTCAGGTCATC -> TCAGGTCATCA
TATGATGTAAA -> ATGATGTAAAA
AGAGTCTACCA -> GAGTCTACCAC
TAAAGGGCAGT -> AAAGGGCAGTT
ACTCGGTGAGC -> CTCGGTGAGCT
CGAAAGCACCT -> GAAAGCACCTT
TGTTTACGTCC -> GTTTACGTCCA
CTTGCCTAACA -> TTGCCTAACAA
ATTTTTGGGAA -> TTTTTGGGAAC
GAGCTTTGGGT -> AGCTTTGGGTG
GCTCAACTAGC -> CTCAACTAGCT
CTCGATCACTA -> TCGATCACTAA
GGATACCGATG -> GATACCGATGC
CCTCGCACGAA -> CTCGCACGAAT
GGGAGAAGAAC -> GGAGAAGAACG
CACCCCATACG -> ACCCCATACGT
TTGGCAGATTA -> TGGCAGATTAA
TGGGGCGCTAG -> GGGGCGCTAGA
TTGCATTGTAT -> TGCATTGTATT
TGGGCTTAGGC -> GGGCTTAGGCA
GTCCGTTCATT -> TCCGTTCATTG
ACTCTCGTTCA -> CTCTCGTTCAT
CAGGAAAGCGA -> AGGAAAGCGAT
GAAGAGGGTGG -> AAGAGGGTGGA
TTTCCTGTATG -> TTCCTGTATGA
GCTCAATCGCC -> CTCAATCGCCC
GATTAACATAC -> ATTAACATACA
GAACATGAAGT -> AACATGAAGTT
AGGAACCGCCC -> GGAACCGCCCG
ACTGCCATCCC -> CTGCCATCCCT
GTCAAAGAAGT -> TCAAAGAAGTT
CGATTCACTAC -> GATTCACTACT
CATCTTGACAC -> ATCTTGACACA
GTGAAATGAGG -> TGAAATGAGGA
AGTGTGACTGT -> GTGTGACTGTG
CAGTCGACACC -> AGTCGACACCC
GAGGTGTGCCT -> AGGTGTGCCTC
TTCGAGCGGAT -> TCGAGCGGATA
ATAGCGTAATT -> TAGCGTAATTC
CGTGCAAGATC -> GTGCAAGATCC
TGATGTGCCCG -> GATGTGCCCGT
TGAGACTGCCA -> GAGACTGCCAT
TACCACCAATG -> ACCACCAATGG
CCGGCGGATAG -> CGGCGGATAGC
TAAACATCACA -> AAACATCACAA
AAAGCACCTTG -> AAGCACCTTGT
CACCGCTCAAT -> ACCGCTCAATC
GTGCCTCTCGA -> TGCCTCTCGAT
AACGACCATGT -> ACGACCATGTT
GTTCACGCGCA -> TTCACGCGCAG
TCTACCACCAA -> CTACCACCAAT
CTTAGCACTAA -> TTAGCACTAAA
GTTGGCGAGCA -> TTGGCGAGCAT
AAGCATAAATG -> AGCATAAATGC
GGGCACCCAAA -> GGCACCCAAAG
CAGCAGGAAAG -> AGCAGGAAAGC
TGACGGATTTG -> GACGGATTTGG
AACCGAATGGG -> ACCGAATGGGG
CCTTCGGATTC -> CTTCGGATTCG
TTATTCGCGCA -> TATTCGCGCAG
ACAGACCAGCG -> CAGACCAGCGT
AGTTCACGCGC -> GTTCACGCGCA
CGACGGACAGA -> GACGGACAGAC
ACTAAAGGGCA -> CTAAAGGGCAG
GTCCGCCTGCA -> TCCGCCTGCAG
TGCATAAAAGT -> GCATAAAAGTC
GCTCCTAAACC -> CTCCTAAACCT
AGACTGCCATC -> GACTGCCATCC
CCAAAACTAAA -> CAAAACTAAAC
GTACCCTGCGT -> TACCCTGCGTT
TAAAGCCGTTA -> AAAGCCGTTAG
GAAAGCGATGA -> AAAGCGATGAG
GACCTTGCCTA -> ACCTTGCCTAA
AGAGTTACCTT -> GAGTTACCTTT
GACCCTGGCCT -> ACCCTGGCCTT
TTTCGACACAT -> TTCGACACATC
TTATGTTAAAA -> TATGTTAAAAG
GAGGTGTGGTT -> AGGTGTGGTTC
CGTACGAGGTG -> GTACGAGGTGT
TTGCTGCTTCA -> TGCTGCTTCAA
ATTTCCTGTAT -> TTTCCTGTATG
TTAGGTAGCTC -> TAGGTAGCTCC
GCCTGCGCGGT -> CCTGCGCGGTT
TCCTCGTGAAC -> CCTCGTGAACA
GCCATTTTCCA -> CCATTTTCCAA
AGGAAAGCGAT -> GGAAAGCGATG
AGGAGTGGAAA -> GGAGTGGAAAT
AAACCCTCTCC -> AACCCTCTCCC
GTGAGTCAAAG -> TGAGTCAAAGA
AGCTCCTAGTA -> GCTCCTAGTAT
ATTATTCCCTC -> TTATTCCCTCA
CCCGTGACTAC -> CCGTGACTACG
ATTACGGTTCG -> TTACGGTTCGG
GATGCATAAAA -> ATGCATAAAAG
AAGTTCACGCG -> AGTTCACGCGC
GCCCACCAGGG -> CCCACCAGGGT
TGGGGCAAGTT -> GGGGCAAGTTA
TCTCTCCGCAC -> CTCTCCGCACA
CAGCGTGTAAC -> AGCGTGTAACG
CAAGTTAGCCT -> AAGTTAGCCTG
CCCTTCGCGCT -> CCTTCGCGCTA
CGCCCGGTAGG -> GCCCGGTAGGA
GTCCATTAATT -> TCCATTAATTT
GATGCCAGCAG -> ATGCCAGCAGG
CAAGTACTCTT -> AAGTACTCTTG
AGCGTGAAATG -> GCGTGAAATGA
ACCCAAATAGT -> CCCAAATAGTG
GTGAACATGAA -> TGAACATGAAG
CCATGTTTACG -> CATGTTTACGT
TAACCAATTCG -> AACCAATTCGA
ATCATGGTCGG -> TCATGGTCGGT
AGAATGATGCC -> GAATGATGCCA
AGGGAATTTTC -> GGGAATTTTCT
AGATGCATAAA -> GATGCATAAAA
TAGTCCTCGTG -> AGTCCTCGTGA
TATTCGCGCAG -> ATTCGCGCAGC
TCGCACGAATG -> CGCACGAATGA
GAATGAATACA -> AATGAATACAC
GTGGCCTGGAA -> TGGCCTGGAAG
ATTGGCCATTT -> TTGGCCATTTT
CAGGGTCTGCC -> AGGGTCTGCCT
GTGACTTACTT -> TGACTTACTTA
GTGGTTCCATT -> TGGTTCCATTA
AATTCAGGTCA -> ATTCAGGTCAT
TGGCGAGCATA -> GGCGAGCATAG
TCCGCACACCC -> CCGCACACCCC
ACGAATGAATA -> CGAATGAATAC
GAGTGGAAATA -> AGTGGAAATAT
GACTCTCGTTC -> ACTCTCGTTCA
GAGGCTTAAAC -> AGGCTTAAACG
TAGAATGTCTG -> AGAATGTCTGG
GCAGAGGTGGG -> CAGAGGTGGGC
GACCTCATTAT -> ACCTCATTATC
TGGATCCTCGC -> GGATCCTCGCA
TAGCGGTCACC -> AGCGGTCACCT
AGGACCTTGCC -> GGACCTTGCCT
GGTACGGGTTA -> GTACGGGTTAG
AGGCTGGATCA -> GGCTGGATCAT
GCGGTTTATAA -> CGGTTTATAAA
TAGATTACCTG -> AGATTACCTGC
CAGGACACGGC -> AGGACACGGCC
GCAAGATCCGG -> CAAGATCCGGG
GGAAAGCGATG -> GAAAGCGATGA
ACCCATGCCTA -> CCCATGCCTAC
GTTAGGGAGGT -> TTAGGGAGGTG
CGATTGTGAAT -> GATTGTGAATT
CCCTCCTCTAG -> CCTCCTCTAGG
AACGAAAGAAC -> ACGAAAGAACC
TAATCACGGTA -> AATCACGGTAT
GGGGCAAGTTA -> GGGCAAGTTAG
