GCGAGCGTGTAGAGATACTG -> CGAGCGTGTAGAGATACTGG
CTAGGCCGCCTTAAGTGTAC -> TAGGCCGCCTTAAGTGTACT
GAGCTGTCGTCTCGTTGGTG -> AGCTGTCGTCTCGTTGGTGA
CCCACCCCCCTTGTAACTCC -> CCACCCCCCTTGTAACTCCC
AGGTTCTTCCGGAGCAATCT -> GGTTCTTCCGGAGCAATCTC
TGTAACTCTCCCCCTGTTGA -> GTAACTCTCCCCCTGTTGAT
AACTCGGTCCTCCGCATATT -> ACTCGGTCCTCCGCATATTC
CGTCATGTGAGGCCAAGTGG -> GTCATGTGAGGCCAAGTGGG
TCTTGCCTGCGACTGAAGAT -> CTTGCCTGCGACTGAAGATA
ACATCATGGTCAGCGTGACC -> CATCATGGTCAGCGTGACCC
ATTCCTGAGGCAGCTCTTAA -> TTCCTGAGGCAGCTCTTAAA
GATCGGGAGGTACGTCATGT -> ATCGGGAGGTACGTCATGTG
GTCCGGACAGGTCTAGCCCA -> TCCGGACAGGTCTAGCCCAC
CATTATGACATCATGGTCAG -> ATTATGACATCATGGTCAGC
TCTCGTTGGTGAGCACGCCC -> CTCGTTGGTGAGCACGCCCA
ATTAGGCTAGGCCGCCTTAA -> TTAGGCTAGGCCGCCTTAAG
TAGAGATACTGGTTACATAC -> AGAGATACTGGTTACATACG
AAAGGCGTCCGGACAGGTCT -> AAGGCGTCCGGACAGGTCTA
ATGTCACCCCGTCCGTAAAA -> TGTCACCCCGTCCGTAAAAT
TCTCTTGCCTGCGACTGAAG -> CTCTTGCCTGCGACTGAAGA
TAGCCCCGGTAGTGCTATAC -> AGCCCCGGTAGTGCTATACC
GTACAGTGAGGGCAATCCGC -> TACAGTGAGGGCAATCCGCG
CCCTACATAATCCATCACTT -> CCTACATAATCCATCACTTG
CTACATAATCCATCACTTGA -> TACATAATCCATCACTTGAT
CCCAAGTGCTGGCCACAAAG -> CCAAGTGCTGGCCACAAAGG
CGTTGAGCATCGAATAGCCC -> GTTGAGCATCGAATAGCCCC
GAAAACTAGGGACTCAGACT -> AAAACTAGGGACTCAGACTC
CCATTGGAGGTCACTCTGCT -> CATTGGAGGTCACTCTGCTA
TTGGTACAGACCGGCGAGGA -> TGGTACAGACCGGCGAGGAG
ATGGAACCAATACAATTCAT -> TGGAACCAATACAATTCATT
CAAAAGCATGTGAGTAGCGA -> AAAAGCATGTGAGTAGCGAT
GAGTTGGGAAAACTAGGGAC -> AGTTGGGAAAACTAGGGACT
ATAGCCCCTATCAGATTAGA -> TAGCCCCTATCAGATTAGAT
TCCCGTGTTGAGACATGGTC -> CCCGTGTTGAGACATGGTCG
GGGAAAACTAGGGACTCAGA -> GGAAAACTAGGGACTCAGAC
TCAAAACTATGTGACGCCAA -> CAAAACTATGTGACGCCAAA
ACCCAAGTGCTGGCCACAAA -> CCCAAGTGCTGGCCACAAAG
CGAAGCTCCCTGTCGGCTCT -> GAAGCTCCCTGTCGGCTCTA
TGAGGGCAATCCGCGATTCT -> GAGGGCAATCCGCGATTCTG
ATCCGAGCATTATCGTTTTA -> TCCGAGCATTATCGTTTTAC
GTAACATTTTGTCAAAACTA -> TAACATTTTGTCAAAACTAT
TATGACATCATGGTCAGCGT -> ATGACATCATGGTCAGCGTG
CTGATCCGAGCATTATCGTT -> TGATCCGAGCATTATCGTTT
AACCAATACAATTCATTGCA -> ACCAATACAATTCATTGCAG
CGTCTCGTTGGTGAGCACGC -> GTCTCGTTGGTGAGCACGCC
AGCTGTCGTCTCGTTGGTGA -> GCTGTCGTCTCGTTGGTGAG
CCGGGCAAAAAAGGACTCGT -> CGGGCAAAAAAGGACTCGTT
TGACGCCAAAAGGCGTTCTA -> GACGCCAAAAGGCGTTCTAA
CAAACGACTCGGCCTCTTGG -> AAACGACTCGGCCTCTTGGT
GAAGGTTCTTCCGGAGCAAT -> AAGGTTCTTCCGGAGCAATC
GTCATGTGAGGCCAAGTGGG -> TCATGTGAGGCCAAGTGGGA
TTAGGCTAGGCCGCCTTAAG -> TAGGCTAGGCCGCCTTAAGT
CTTAATAGGCCGTACAGTGA -> TTAATAGGCCGTACAGTGAG
CTTAAGTGTACTTCGGTCAA -> TTAAGTGTACTTCGGTCAAA
AGTATGGAAGGAAGCTACTA -> GTATGGAAGGAAGCTACTAT
CTCCCGGAGAACAGGTATCG -> TCCCGGAGAACAGGTATCGT
TCTTAAACGGCTGTAACTCT -> CTTAAACGGCTGTAACTCTC
GCGAGCTGTCGTCTCGTTGG -> CGAGCTGTCGTCTCGTTGGT
GTCACTGGTAAATACGAGTA -> TCACTGGTAAATACGAGTAA
CTGGTAAATACGAGTAATCC -> TGGTAAATACGAGTAATCCG
TACAATTCATTGCAGGCTGA -> ACAATTCATTGCAGGCTGAT
TGTGAGTAGCGATGTCGGAT -> GTGAGTAGCGATGTCGGATA
CACAAACGACTCGGCCTCTT -> ACAAACGACTCGGCCTCTTG
CAGGCCATTGGAGGTCACTC -> AGGCCATTGGAGGTCACTCT
TAAGCAGTGCACGGTCCCGT -> AAGCAGTGCACGGTCCCGTG
GTAACTCCCGGAGAACAGGT -> TAACTCCCGGAGAACAGGTA
TAGCCCCTATCAGATTAGAT -> AGCCCCTATCAGATTAGATG
CAAGTGCTGGCCACAAAGGC -> AAGTGCTGGCCACAAAGGCG
GGTAAATACGAGTAATCCGC -> GTAAATACGAGTAATCCGCT
GGGACTCAGACTCGGGGTAA -> GGACTCAGACTCGGGGTAAC
GGTCTAGCCCACTTCTGTCA -> GTCTAGCCCACTTCTGTCAC
TCTAGCCCACTTCTGTCACT -> CTAGCCCACTTCTGTCACTG
TGTTCACGTTTGAAGGTTCT -> GTTCACGTTTGAAGGTTCTT
ATAGCCCCGGTAGTGCTATA -> TAGCCCCGGTAGTGCTATAC
CGACTGAAGATAAGCAGTGC -> GACTGAAGATAAGCAGTGCA
GTTCATGAATGGCTACCGGG -> TTCATGAATGGCTACCGGGC
GGAGCAATCTCACACCCGCT -> GAGCAATCTCACACCCGCTT
AATCTTCTCAATCACATTAT -> ATCTTCTCAATCACATTATG
TAAAATTCCGATAGCCCCGG -> AAAATTCCGATAGCCCCGGT
TAATCCATCACTTGATTAAA -> AATCCATCACTTGATTAAAA
ACACCCGCTTGATCCCAATT -> CACCCGCTTGATCCCAATTT
ACTATGTGACGCCAAAAGGC -> CTATGTGACGCCAAAAGGCG
TGTGACGCCAAAAGGCGTTC -> GTGACGCCAAAAGGCGTTCT
CGAATAGCCCCTATCAGATT -> GAATAGCCCCTATCAGATTA
TGGGAAAACTAGGGACTCAG -> GGGAAAACTAGGGACTCAGA
CCGGACAGGTCTAGCCCACT -> CGGACAGGTCTAGCCCACTT
GCACGCCCAGCTGACTCATA -> CACGCCCAGCTGACTCATAA
CGTTTTACCACCTTGCACTG -> GTTTTACCACCTTGCACTGG
ATTTTGTCAAAACTATGTGA -> TTTTGTCAAAACTATGTGAC
AGGCCGCCTTAAGTGTACTT -> GGCCGCCTTAAGTGTACTTC
GGGCAAAAAAGGACTCGTTG -> GGCAAAAAAGGACTCGTTGA
GGAAACACACAAACGACTCG -> GAAACACACAAACGACTCGG
CGTGTAGAGATACTGGTTAC -> GTGTAGAGATACTGGTTACA
GGTCCCGTGTTGAGACATGG -> GTCCCGTGTTGAGACATGGT
TAAATACGAGTAATCCGCTT -> AAATACGAGTAATCCGCTTA
TTCGGTCAAAAGCATGTGAG -> TCGGTCAAAAGCATGTGAGT
TCGTTTTACCACCTTGCACT -> CGTTTTACCACCTTGCACTG
GAGCGTGTAGAGATACTGGT -> AGCGTGTAGAGATACTGGTT
TTCATTGCAGGCTGATCCGA -> TCATTGCAGGCTGATCCGAG
ATCGAATAGCCCCTATCAGA -> TCGAATAGCCCCTATCAGAT
GGGTGTTCACGTTTGAAGGT -> GGTGTTCACGTTTGAAGGTT
CAGAAACCATCCATAATACC -> AGAAACCATCCATAATACCC
AAGGACTCGTTGAGCATCGA -> AGGACTCGTTGAGCATCGAA
GGAAGGAAGCTACTATGTTA -> GAAGGAAGCTACTATGTTAA
GGCGTCCGGACAGGTCTAGC -> GCGTCCGGACAGGTCTAGCC
ACAGCAGGCCATTGGAGGTC -> CAGCAGGCCATTGGAGGTCA
TAACCCACCCCCCTTGTAAC -> AACCCACCCCCCTTGTAACT
GCAGCTCTTAAACGGCTGTA -> CAGCTCTTAAACGGCTGTAA
TTGCACTGGGTGTTCACGTT -> TGCACTGGGTGTTCACGTTT
AATCTCACACCCGCTTGATC -> ATCTCACACCCGCTTGATCC
CATTTTGTCAAAACTATGTG -> ATTTTGTCAAAACTATGTGA
TAGATGTCACCCCGTCCGTA -> AGATGTCACCCCGTCCGTAA
CTTGATCCCAATTTATAACC -> TTGATCCCAATTTATAACCC
CTAATGGAACCAATACAATT -> TAATGGAACCAATACAATTC
ATACCCTACATAATCCATCA -> TACCCTACATAATCCATCAC
ATAATCCATCACTTGATTAA -> TAATCCATCACTTGATTAAA
CCCAATTTATAACCCACCCC -> CCAATTTATAACCCACCCCC
AATACGAGTAATCCGCTTAT -> ATACGAGTAATCCGCTTATA
CACACCCGCTTGATCCCAAT -> ACACCCGCTTGATCCCAATT
GCAAAAAAGGACTCGTTGAG -> CAAAAAAGGACTCGTTGAGC
TCCGCTTATAGGAAACACAC -> CCGCTTATAGGAAACACACA
CATGGTCAGCGTGACCCAAG -> ATGGTCAGCGTGACCCAAGT
GTCTAGCCCACTTCTGTCAC -> TCTAGCCCACTTCTGTCACT
GTTACATACGAGGGTGCGAG -> TTACATACGAGGGTGCGAGC
CGCTTATAGGAAACACACAA -> GCTTATAGGAAACACACAAA
CCCGGAGAACAGGTATCGTT -> CCGGAGAACAGGTATCGTTT
AACCATCCATAATACCCTAC -> ACCATCCATAATACCCTACA
TCACCCCGTCCGTAAAATTC -> CACCCCGTCCGTAAAATTCC
AGGCGTTCTAATTCAGAAAC -> GGCGTTCTAATTCAGAAACC
ACCGGCGAGGAGTTGGGAAA -> CCGGCGAGGAGTTGGGAAAA
TATCGTTTTACCACCTTGCA -> ATCGTTTTACCACCTTGCAC
TCACGTTTGAAGGTTCTTCC -> CACGTTTGAAGGTTCTTCCG
TGACTCATAAACTCGAAGCT -> GACTCATAAACTCGAAGCTC
CTTCCGGAGCAATCTCACAC -> TTCCGGAGCAATCTCACACC
AATAGGCCGTACAGTGAGGG -> ATAGGCCGTACAGTGAGGGC
CTCGGGGTAACATTTTGTCA -> TCGGGGTAACATTTTGTCAA
CCAAGTGGGACGAAGTATGG -> CAAGTGGGACGAAGTATGGA
AAGGCGTTCTAATTCAGAAA -> AGGCGTTCTAATTCAGAAAC
ATGGAAGGAAGCTACTATGT -> TGGAAGGAAGCTACTATGTT
AAAATTCCGATAGCCCCGGT -> AAATTCCGATAGCCCCGGTA
GGTACGTCATGTGAGGCCAA -> GTACGTCATGTGAGGCCAAG
ACATTATGACATCATGGTCA -> CATTATGACATCATGGTCAG
CACACAAACGACTCGGCCTC -> ACACAAACGACTCGGCCTCT
GCTGTAACTCTCCCCCTGTT -> CTGTAACTCTCCCCCTGTTG
TGCACTGGGTGTTCACGTTT -> GCACTGGGTGTTCACGTTTG
AACATTTTGTCAAAACTATG -> ACATTTTGTCAAAACTATGT
TTATAACCCACCCCCCTTGT -> TATAACCCACCCCCCTTGTA
AAACACACAAACGACTCGGC -> AACACACAAACGACTCGGCC
AAAGGCGTTCTAATTCAGAA -> AAGGCGTTCTAATTCAGAAA
AAGCAGTGCACGGTCCCGTG -> AGCAGTGCACGGTCCCGTGT
CTTGGTACAGACCGGCGAGG -> TTGGTACAGACCGGCGAGGA
TGCTATACCAAACTCGGTCC -> GCTATACCAAACTCGGTCCT
CCTCCGCATATTCCTGAGGC -> CTCCGCATATTCCTGAGGCA
GCAAAATTAGGCTAGGCCGC -> CAAAATTAGGCTAGGCCGCC
TTCATGAATGGCTACCGGGC -> TCATGAATGGCTACCGGGCA
CTGAGGCAGCTCTTAAACGG -> TGAGGCAGCTCTTAAACGGC
GCGTCCGGACAGGTCTAGCC -> CGTCCGGACAGGTCTAGCCC
TAATCCGCTTATAGGAAACA -> AATCCGCTTATAGGAAACAC
AGGCCAAGTGGGACGAAGTA -> GGCCAAGTGGGACGAAGTAT
CGGGGTAACATTTTGTCAAA -> GGGGTAACATTTTGTCAAAA
AGTGGGACGAAGTATGGAAG -> GTGGGACGAAGTATGGAAGG
TCGGATACAGCAGGCCATTG -> CGGATACAGCAGGCCATTGG
TGACATCATGGTCAGCGTGA -> GACATCATGGTCAGCGTGAC
GACTCAGACTCGGGGTAACA -> ACTCAGACTCGGGGTAACAT
ACCAATACAATTCATTGCAG -> CCAATACAATTCATTGCAGG
GAATAGCCCCTATCAGATTA -> AATAGCCCCTATCAGATTAG
GCCAAAAGGCGTTCTAATTC -> CCAAAAGGCGTTCTAATTCA
CATTGGAGGTCACTCTGCTA -> ATTGGAGGTCACTCTGCTAA
TGTAACTCCCGGAGAACAGG -> GTAACTCCCGGAGAACAGGT
TTCCGGAGCAATCTCACACC -> TCCGGAGCAATCTCACACCC
GGCCTCTTGGTACAGACCGG -> GCCTCTTGGTACAGACCGGC
CGGCCTCTTGGTACAGACCG -> GGCCTCTTGGTACAGACCGG
GCCGCCTTAAGTGTACTTCG -> CCGCCTTAAGTGTACTTCGG
CCTGTCGGCTCTATTAGCCG -> CTGTCGGCTCTATTAGCCGT
AACTATGTGACGCCAAAAGG -> ACTATGTGACGCCAAAAGGC
GTCTCGTTGGTGAGCACGCC -> TCTCGTTGGTGAGCACGCCC
CAGCTGACTCATAAACTCGA -> AGCTGACTCATAAACTCGAA
AACTAGGGACTCAGACTCGG -> ACTAGGGACTCAGACTCGGG
CGAGCTGTCGTCTCGTTGGT -> GAGCTGTCGTCTCGTTGGTG
TTAGATGTCACCCCGTCCGT -> TAGATGTCACCCCGTCCGTA
ATACGAGGGTGCGAGCTGTC -> TACGAGGGTGCGAGCTGTCG
GTCGTGGCAACCAGTACTTC -> TCGTGGCAACCAGTACTTCT
TCGTGGCAACCAGTACTTCT -> CGTGGCAACCAGTACTTCTT
TCGAAGCTCCCTGTCGGCTC -> CGAAGCTCCCTGTCGGCTCT
TTGGGAAAACTAGGGACTCA -> TGGGAAAACTAGGGACTCAG
AATCACATTATGACATCATG -> ATCACATTATGACATCATGG
CGTGTTGAGACATGGTCGTG -> GTGTTGAGACATGGTCGTGG
GAAGATAAGCAGTGCACGGT -> AAGATAAGCAGTGCACGGTC
GTCGTCTCGTTGGTGAGCAC -> TCGTCTCGTTGGTGAGCACG
ACTTGATTAAAAGCGAGCGT -> CTTGATTAAAAGCGAGCGTG
CTAGCCCACTTCTGTCACTG -> TAGCCCACTTCTGTCACTGG
TTAAGTGTACTTCGGTCAAA -> TAAGTGTACTTCGGTCAAAA
GAGTAGCGATGTCGGATACA -> AGTAGCGATGTCGGATACAG
ATGGCTACCGGGCAAAAAAG -> TGGCTACCGGGCAAAAAAGG
CGCATATTCCTGAGGCAGCT -> GCATATTCCTGAGGCAGCTC
ATTCAGAAACCATCCATAAT -> TTCAGAAACCATCCATAATA
CATTGCAGGCTGATCCGAGC -> ATTGCAGGCTGATCCGAGCA
CACTGGGTGTTCACGTTTGA -> ACTGGGTGTTCACGTTTGAA
ACCACCTTGCACTGGGTGTT -> CCACCTTGCACTGGGTGTTC
TGGTAAATACGAGTAATCCG -> GGTAAATACGAGTAATCCGC
TTACCACCTTGCACTGGGTG -> TACCACCTTGCACTGGGTGT
ACGCCCAGCTGACTCATAAA -> CGCCCAGCTGACTCATAAAC
CGAGCGTGTAGAGATACTGG -> GAGCGTGTAGAGATACTGGT
GTGTACTTCGGTCAAAAGCA -> TGTACTTCGGTCAAAAGCAT
ACCCCGTCCGTAAAATTCCG -> CCCCGTCCGTAAAATTCCGA
TACTGGTTACATACGAGGGT -> ACTGGTTACATACGAGGGTG
AGCAGGCCATTGGAGGTCAC -> GCAGGCCATTGGAGGTCACT
AGGTCACTCTGCTAATGGAA -> GGTCACTCTGCTAATGGAAC
TGATCAGATCGGGAGGTACG -> GATCAGATCGGGAGGTACGT
CCCCGGTAGTGCTATACCAA -> CCCGGTAGTGCTATACCAAA
CCTGCGACTGAAGATAAGCA -> CTGCGACTGAAGATAAGCAG
AGATACTGGTTACATACGAG -> GATACTGGTTACATACGAGG
GGAAGCTACTATGTTAATCT -> GAAGCTACTATGTTAATCTT
GTTGATCAGATCGGGAGGTA -> TTGATCAGATCGGGAGGTAC
CATGGTCGTGGCAACCAGTA -> ATGGTCGTGGCAACCAGTAC
TGCCTGCGACTGAAGATAAG -> GCCTGCGACTGAAGATAAGC
CCCCCTGTTGATCAGATCGG -> CCCCTGTTGATCAGATCGGG
TACTTCGGTCAAAAGCATGT -> ACTTCGGTCAAAAGCATGTG
TGCAAAATTAGGCTAGGCCG -> GCAAAATTAGGCTAGGCCGC
GCATTATCGTTTTACCACCT -> CATTATCGTTTTACCACCTT
GAGCATTATCGTTTTACCAC -> AGCATTATCGTTTTACCACC
GATACAGCAGGCCATTGGAG -> ATACAGCAGGCCATTGGAGG
AATAGCCCCTATCAGATTAG -> ATAGCCCCTATCAGATTAGA
CGTGGCAACCAGTACTTCTT -> GTGGCAACCAGTACTTCTTA
CTTGATTAAAAGCGAGCGTG -> TTGATTAAAAGCGAGCGTGT
GTACTTCGGTCAAAAGCATG -> TACTTCGGTCAAAAGCATGT
CCCCGTCCGTAAAATTCCGA -> CCCGTCCGTAAAATTCCGAT
GTCCCGTGTTGAGACATGGT -> TCCCGTGTTGAGACATGGTC
GGACTCGTTGAGCATCGAAT -> GACTCGTTGAGCATCGAATA
TAGTGTGCAAAATTAGGCTA -> AGTGTGCAAAATTAGGCTAG
CGTCCGTAAAATTCCGATAG -> GTCCGTAAAATTCCGATAGC
CCCTATCAGATTAGATGTCA -> CCTATCAGATTAGATGTCAC
CCACCTTGCACTGGGTGTTC -> CACCTTGCACTGGGTGTTCA
AGTGTACTTCGGTCAAAAGC -> GTGTACTTCGGTCAAAAGCA
TTATCGTTTTACCACCTTGC -> TATCGTTTTACCACCTTGCA
GACATGGTCGTGGCAACCAG -> ACATGGTCGTGGCAACCAGT
ACGAGTAATCCGCTTATAGG -> CGAGTAATCCGCTTATAGGA
GGACGAAGTATGGAAGGAAG -> GACGAAGTATGGAAGGAAGC
ACTCTGCTAATGGAACCAAT -> CTCTGCTAATGGAACCAATA
ACAGGTCTAGCCCACTTCTG -> CAGGTCTAGCCCACTTCTGT
ACCCCCCTTGTAACTCCCGG -> CCCCCCTTGTAACTCCCGGA
AAAACTATGTGACGCCAAAA -> AAACTATGTGACGCCAAAAG
ACCCGCTTGATCCCAATTTA -> CCCGCTTGATCCCAATTTAT
CAAACTCGGTCCTCCGCATA -> AAACTCGGTCCTCCGCATAT
CTCGGTCCTCCGCATATTCC -> TCGGTCCTCCGCATATTCCT
TGGGTGTTCACGTTTGAAGG -> GGGTGTTCACGTTTGAAGGT
AGCGTGACCCAAGTGCTGGC -> GCGTGACCCAAGTGCTGGCC
AGGAAGCTACTATGTTAATC -> GGAAGCTACTATGTTAATCT
TGGGACGAAGTATGGAAGGA -> GGGACGAAGTATGGAAGGAA
AAGTGTACTTCGGTCAAAAG -> AGTGTACTTCGGTCAAAAGC
GGGAGGTACGTCATGTGAGG -> GGAGGTACGTCATGTGAGGC
CATATTCCTGAGGCAGCTCT -> ATATTCCTGAGGCAGCTCTT
TGAGCACGCCCAGCTGACTC -> GAGCACGCCCAGCTGACTCA
GTGACCCAAGTGCTGGCCAC -> TGACCCAAGTGCTGGCCACA
GGTACAGACCGGCGAGGAGT -> GTACAGACCGGCGAGGAGTT
TTCTGTCACTGGTAAATACG -> TCTGTCACTGGTAAATACGA
TAACATTTTGTCAAAACTAT -> AACATTTTGTCAAAACTATG
CCACTTCTGTCACTGGTAAA -> CACTTCTGTCACTGGTAAAT
ACTCAGACTCGGGGTAACAT -> CTCAGACTCGGGGTAACATT
GCGATGTCGGATACAGCAGG -> CGATGTCGGATACAGCAGGC
CAAAGGCGTCCGGACAGGTC -> AAAGGCGTCCGGACAGGTCT
CGCCAAAAGGCGTTCTAATT -> GCCAAAAGGCGTTCTAATTC
AAATTCCGATAGCCCCGGTA -> AATTCCGATAGCCCCGGTAG
CTATGTTAATCTTCTCAATC -> TATGTTAATCTTCTCAATCA
TCCGAGCATTATCGTTTTAC -> CCGAGCATTATCGTTTTACC
AAAAAAGGACTCGTTGAGCA -> AAAAAGGACTCGTTGAGCAT
ACGTTTGAAGGTTCTTCCGG -> CGTTTGAAGGTTCTTCCGGA
CCGGTAGTGCTATACCAAAC -> CGGTAGTGCTATACCAAACT
CGTTCTAATTCAGAAACCAT -> GTTCTAATTCAGAAACCATC
AAGGAAGCTACTATGTTAAT -> AGGAAGCTACTATGTTAATC
TAATACCCTACATAATCCAT -> AATACCCTACATAATCCATC
CTCACACCCGCTTGATCCCA -> TCACACCCGCTTGATCCCAA
ATAAGCAGTGCACGGTCCCG -> TAAGCAGTGCACGGTCCCGT
AGTTGGGAAAACTAGGGACT -> GTTGGGAAAACTAGGGACTC
TGTCACTGGTAAATACGAGT -> GTCACTGGTAAATACGAGTA
GAAACCATCCATAATACCCT -> AAACCATCCATAATACCCTA
CTCATAAACTCGAAGCTCCC -> TCATAAACTCGAAGCTCCCT
CACTTCTGTCACTGGTAAAT -> ACTTCTGTCACTGGTAAATA
AAGCATGTGAGTAGCGATGT -> AGCATGTGAGTAGCGATGTC
GATCCCAATTTATAACCCAC -> ATCCCAATTTATAACCCACC
ACGTCATGTGAGGCCAAGTG -> CGTCATGTGAGGCCAAGTGG
GGCGTTCTAATTCAGAAACC -> GCGTTCTAATTCAGAAACCA
GTGTAGAGATACTGGTTACA -> TGTAGAGATACTGGTTACAT
CTCTTGGTACAGACCGGCGA -> TCTTGGTACAGACCGGCGAG
CAGCGTGACCCAAGTGCTGG -> AGCGTGACCCAAGTGCTGGC
TTCTTAATAGGCCGTACAGT -> TCTTAATAGGCCGTACAGTG
CACTGGTAAATACGAGTAAT -> ACTGGTAAATACGAGTAATC
AAACTAGGGACTCAGACTCG -> AACTAGGGACTCAGACTCGG
CTCGTTGGTGAGCACGCCCA -> TCGTTGGTGAGCACGCCCAG
GTACTTCTTAATAGGCCGTA -> TACTTCTTAATAGGCCGTAC
GGTGCGAGCTGTCGTCTCGT -> GTGCGAGCTGTCGTCTCGTT
AGTGAGGGCAATCCGCGATT -> GTGAGGGCAATCCGCGATTC
AGGCTAGGCCGCCTTAAGTG -> GGCTAGGCCGCCTTAAGTGT
ACTGGTTACATACGAGGGTG -> CTGGTTACATACGAGGGTGC
TCCATCACTTGATTAAAAGC -> CCATCACTTGATTAAAAGCG
TTCCGATAGCCCCGGTAGTG -> TCCGATAGCCCCGGTAGTGC
ACGAAGTATGGAAGGAAGCT -> CGAAGTATGGAAGGAAGCTA
AAAAGCATGTGAGTAGCGAT -> AAAGCATGTGAGTAGCGATG
GCATCGAATAGCCCCTATCA -> CATCGAATAGCCCCTATCAG
GCGAGGAGTTGGGAAAACTA -> CGAGGAGTTGGGAAAACTAG
GCAGGCCATTGGAGGTCACT -> CAGGCCATTGGAGGTCACTC
GGAACCAATACAATTCATTG -> GAACCAATACAATTCATTGC
TTGAAGGTTCTTCCGGAGCA -> TGAAGGTTCTTCCGGAGCAA
GTTCTAATTCAGAAACCATC -> TTCTAATTCAGAAACCATCC
CAGGTATCGTTTCTCTTGCC -> AGGTATCGTTTCTCTTGCCT
GCTCCCTGTCGGCTCTATTA -> CTCCCTGTCGGCTCTATTAG
GTTGAGCATCGAATAGCCCC -> TTGAGCATCGAATAGCCCCT
CAATTCATTGCAGGCTGATC -> AATTCATTGCAGGCTGATCC
GCAGTGCACGGTCCCGTGTT -> CAGTGCACGGTCCCGTGTTG
CGTGACCCAAGTGCTGGCCA -> GTGACCCAAGTGCTGGCCAC
ACTGGTAAATACGAGTAATC -> CTGGTAAATACGAGTAATCC
TCTGCTAATGGAACCAATAC -> CTGCTAATGGAACCAATACA
TAATTCAGAAACCATCCATA -> AATTCAGAAACCATCCATAA
GAGGTACGTCATGTGAGGCC -> AGGTACGTCATGTGAGGCCA
TTTATAACCCACCCCCCTTG -> TTATAACCCACCCCCCTTGT
TTTACCACCTTGCACTGGGT -> TTACCACCTTGCACTGGGTG
ATTCCGATAGCCCCGGTAGT -> TTCCGATAGCCCCGGTAGTG
TCTTCCGGAGCAATCTCACA -> CTTCCGGAGCAATCTCACAC
GAAGCTACTATGTTAATCTT -> AAGCTACTATGTTAATCTTC
CACGGTCCCGTGTTGAGACA -> ACGGTCCCGTGTTGAGACAT
GCAATCTCACACCCGCTTGA -> CAATCTCACACCCGCTTGAT
ATGTCGGATACAGCAGGCCA -> TGTCGGATACAGCAGGCCAT
GATGTCGGATACAGCAGGCC -> ATGTCGGATACAGCAGGCCA
AAACTCGGTCCTCCGCATAT -> AACTCGGTCCTCCGCATATT
AGGACTCGTTGAGCATCGAA -> GGACTCGTTGAGCATCGAAT
GCTCTTAAACGGCTGTAACT -> CTCTTAAACGGCTGTAACTC
ACTTCTTAATAGGCCGTACA -> CTTCTTAATAGGCCGTACAG
GGAGAACAGGTATCGTTTCT -> GAGAACAGGTATCGTTTCTC
TGTCGTCTCGTTGGTGAGCA -> GTCGTCTCGTTGGTGAGCAC
TCCATAATACCCTACATAAT -> CCATAATACCCTACATAATC
AGTACTTCTTAATAGGCCGT -> GTACTTCTTAATAGGCCGTA
CTACTATGTTAATCTTCTCA -> TACTATGTTAATCTTCTCAA
ACTCTCCCCCTGTTGATCAG -> CTCTCCCCCTGTTGATCAGA
CTTGCCTGCGACTGAAGATA -> TTGCCTGCGACTGAAGATAA
CAGACCGGCGAGGAGTTGGG -> AGACCGGCGAGGAGTTGGGA
TTAAAAGCGAGCGTGTAGAG -> TAAAAGCGAGCGTGTAGAGA
TGGTCGTGGCAACCAGTACT -> GGTCGTGGCAACCAGTACTT
TGCACGGTCCCGTGTTGAGA -> GCACGGTCCCGTGTTGAGAC
GCTACCGGGCAAAAAAGGAC -> CTACCGGGCAAAAAAGGACT
CATCACTTGATTAAAAGCGA -> ATCACTTGATTAAAAGCGAG
CCCCTTGTAACTCCCGGAGA -> CCCTTGTAACTCCCGGAGAA
CCAAGTGCTGGCCACAAAGG -> CAAGTGCTGGCCACAAAGGC
AAAAGGCGTTCTAATTCAGA -> AAAGGCGTTCTAATTCAGAA
GACTCATAAACTCGAAGCTC -> ACTCATAAACTCGAAGCTCC
TTCCTGAGGCAGCTCTTAAA -> TCCTGAGGCAGCTCTTAAAC
TAGGCTAGGCCGCCTTAAGT -> AGGCTAGGCCGCCTTAAGTG
AATACCCTACATAATCCATC -> ATACCCTACATAATCCATCA
AACGACTCGGCCTCTTGGTA -> ACGACTCGGCCTCTTGGTAC
GGGGTAACATTTTGTCAAAA -> GGGTAACATTTTGTCAAAAC
TGATCCGAGCATTATCGTTT -> GATCCGAGCATTATCGTTTT
ATGGTCGTGGCAACCAGTAC -> TGGTCGTGGCAACCAGTACT
TTCAGAAACCATCCATAATA -> TCAGAAACCATCCATAATAC
GTGGGACGAAGTATGGAAGG -> TGGGACGAAGTATGGAAGGA
TGTTAATCTTCTCAATCACA -> GTTAATCTTCTCAATCACAT
TAATGGAACCAATACAATTC -> AATGGAACCAATACAATTCA
GGTATCGTTTCTCTTGCCTG -> GTATCGTTTCTCTTGCCTGC
TGTACTTCGGTCAAAAGCAT -> GTACTTCGGTCAAAAGCATG
TTGATCAGATCGGGAGGTAC -> TGATCAGATCGGGAGGTACG
TAGGAAACACACAAACGACT -> AGGAAACACACAAACGACTC
GACGAAGTATGGAAGGAAGC -> ACGAAGTATGGAAGGAAGCT
GCGTGACCCAAGTGCTGGCC -> CGTGACCCAAGTGCTGGCCA
TTTGAAGGTTCTTCCGGAGC -> TTGAAGGTTCTTCCGGAGCA
AAAAGGACTCGTTGAGCATC -> AAAGGACTCGTTGAGCATCG
TGCGACTGAAGATAAGCAGT -> GCGACTGAAGATAAGCAGTG
CAGTACTTCTTAATAGGCCG -> AGTACTTCTTAATAGGCCGT
TGAAGATAAGCAGTGCACGG -> GAAGATAAGCAGTGCACGGT
TCCGTAAAATTCCGATAGCC -> CCGTAAAATTCCGATAGCCC
CTCGGCCTCTTGGTACAGAC -> TCGGCCTCTTGGTACAGACC
TCGGGGTAACATTTTGTCAA -> CGGGGTAACATTTTGTCAAA
CGGCGAGGAGTTGGGAAAAC -> GGCGAGGAGTTGGGAAAACT
CAAAAAAGGACTCGTTGAGC -> AAAAAAGGACTCGTTGAGCA
GTGCACGGTCCCGTGTTGAG -> TGCACGGTCCCGTGTTGAGA
ACTCGGCCTCTTGGTACAGA -> CTCGGCCTCTTGGTACAGAC
TATGGAAGGAAGCTACTATG -> ATGGAAGGAAGCTACTATGT
ACCATCCATAATACCCTACA -> CCATCCATAATACCCTACAT
TCTGTTCATGAATGGCTACC -> CTGTTCATGAATGGCTACCG
GGCTAGGCCGCCTTAAGTGT -> GCTAGGCCGCCTTAAGTGTA
ATCGGGAGGTACGTCATGTG -> TCGGGAGGTACGTCATGTGA
AAAAAGGACTCGTTGAGCAT -> AAAAGGACTCGTTGAGCATC
AATGGCTACCGGGCAAAAAA -> ATGGCTACCGGGCAAAAAAG
AGGCGTCCGGACAGGTCTAG -> GGCGTCCGGACAGGTCTAGC
CATACGAGGGTGCGAGCTGT -> ATACGAGGGTGCGAGCTGTC
ACCTTGCACTGGGTGTTCAC -> CCTTGCACTGGGTGTTCACG
AGGAAACACACAAACGACTC -> GGAAACACACAAACGACTCG
AAATACGAGTAATCCGCTTA -> AATACGAGTAATCCGCTTAT
TCTCACACCCGCTTGATCCC -> CTCACACCCGCTTGATCCCA
TCCGATAGCCCCGGTAGTGC -> CCGATAGCCCCGGTAGTGCT
ACCGGGCAAAAAAGGACTCG -> CCGGGCAAAAAAGGACTCGT
AAGGTTCTTCCGGAGCAATC -> AGGTTCTTCCGGAGCAATCT
TCATGGTCAGCGTGACCCAA -> CATGGTCAGCGTGACCCAAG
ATACAGCAGGCCATTGGAGG -> TACAGCAGGCCATTGGAGGT
TGACCCAAGTGCTGGCCACA -> GACCCAAGTGCTGGCCACAA
GGCAAAAAAGGACTCGTTGA -> GCAAAAAAGGACTCGTTGAG
TAAACGGCTGTAACTCTCCC -> AAACGGCTGTAACTCTCCCC
CCCGTCCGTAAAATTCCGAT -> CCGTCCGTAAAATTCCGATA
TAAGTGTACTTCGGTCAAAA -> AAGTGTACTTCGGTCAAAAG
CGTCCGGACAGGTCTAGCCC -> GTCCGGACAGGTCTAGCCCA
CCCGGTAGTGCTATACCAAA -> CCGGTAGTGCTATACCAAAC
CCCAGCTGACTCATAAACTC -> CCAGCTGACTCATAAACTCG
GGGTGCGAGCTGTCGTCTCG -> GGTGCGAGCTGTCGTCTCGT
CGGACAGGTCTAGCCCACTT -> GGACAGGTCTAGCCCACTTC
AGGCAGCTCTTAAACGGCTG -> GGCAGCTCTTAAACGGCTGT
ATCCATCACTTGATTAAAAG -> TCCATCACTTGATTAAAAGC
TGGAAGGAAGCTACTATGTT -> GGAAGGAAGCTACTATGTTA
ATGAATGGCTACCGGGCAAA -> TGAATGGCTACCGGGCAAAA
CTTATAGGAAACACACAAAC -> TTATAGGAAACACACAAACG
GTGAGGCCAAGTGGGACGAA -> TGAGGCCAAGTGGGACGAAG
GCTGTCGTCTCGTTGGTGAG -> CTGTCGTCTCGTTGGTGAGC
CTGGCCACAAAGGCGTCCGG -> TGGCCACAAAGGCGTCCGGA
GTAGTGCTATACCAAACTCG -> TAGTGCTATACCAAACTCGG
GCATATTCCTGAGGCAGCTC -> CATATTCCTGAGGCAGCTCT
GCATGTGAGTAGCGATGTCG -> CATGTGAGTAGCGATGTCGG
GGCCACAAAGGCGTCCGGAC -> GCCACAAAGGCGTCCGGACA
AATCCGCTTATAGGAAACAC -> ATCCGCTTATAGGAAACACA
GGCAATCCGCGATTCTGTTC -> GCAATCCGCGATTCTGTTCA
ACGGTCCCGTGTTGAGACAT -> CGGTCCCGTGTTGAGACATG
GCGTTCTAATTCAGAAACCA -> CGTTCTAATTCAGAAACCAT
AATTAGGCTAGGCCGCCTTA -> ATTAGGCTAGGCCGCCTTAA
AATCCGCGATTCTGTTCATG -> ATCCGCGATTCTGTTCATGA
GGGTAACATTTTGTCAAAAC -> GGTAACATTTTGTCAAAACT
ACCCTACATAATCCATCACT -> CCCTACATAATCCATCACTT
ATTCTGTTCATGAATGGCTA -> TTCTGTTCATGAATGGCTAC
TACCACCTTGCACTGGGTGT -> ACCACCTTGCACTGGGTGTT
TCACTTGATTAAAAGCGAGC -> CACTTGATTAAAAGCGAGCG
ATGTGAGTAGCGATGTCGGA -> TGTGAGTAGCGATGTCGGAT
AATACAATTCATTGCAGGCT -> ATACAATTCATTGCAGGCTG
ATAAACTCGAAGCTCCCTGT -> TAAACTCGAAGCTCCCTGTC
GTAAATACGAGTAATCCGCT -> TAAATACGAGTAATCCGCTT
AATTCATTGCAGGCTGATCC -> ATTCATTGCAGGCTGATCCG
CGAGGAGTTGGGAAAACTAG -> GAGGAGTTGGGAAAACTAGG
GATCAGATCGGGAGGTACGT -> ATCAGATCGGGAGGTACGTC
TATGTGACGCCAAAAGGCGT -> ATGTGACGCCAAAAGGCGTT
TACTTCTTAATAGGCCGTAC -> ACTTCTTAATAGGCCGTACA
CCCCTGTTGATCAGATCGGG -> CCCTGTTGATCAGATCGGGA
AGTAATCCGCTTATAGGAAA -> GTAATCCGCTTATAGGAAAC
CATCCATAATACCCTACATA -> ATCCATAATACCCTACATAA
AGCAGTGCACGGTCCCGTGT -> GCAGTGCACGGTCCCGTGTT
AAGTGCTGGCCACAAAGGCG -> AGTGCTGGCCACAAAGGCGT
ATCCATAATACCCTACATAA -> TCCATAATACCCTACATAAT
GCCCCGGTAGTGCTATACCA -> CCCCGGTAGTGCTATACCAA
AGCTCTTAAACGGCTGTAAC -> GCTCTTAAACGGCTGTAACT
TGATTAAAAGCGAGCGTGTA -> GATTAAAAGCGAGCGTGTAG
ATCCGCTTATAGGAAACACA -> TCCGCTTATAGGAAACACAC
CAACCAGTACTTCTTAATAG -> AACCAGTACTTCTTAATAGG
ACTGGGTGTTCACGTTTGAA -> CTGGGTGTTCACGTTTGAAG
CAGCAGGCCATTGGAGGTCA -> AGCAGGCCATTGGAGGTCAC
TCTTAATAGGCCGTACAGTG -> CTTAATAGGCCGTACAGTGA
TGTGCAAAATTAGGCTAGGC -> GTGCAAAATTAGGCTAGGCC
TATAACCCACCCCCCTTGTA -> ATAACCCACCCCCCTTGTAA
AGCGAGCGTGTAGAGATACT -> GCGAGCGTGTAGAGATACTG
AGCTGACTCATAAACTCGAA -> GCTGACTCATAAACTCGAAG
AGTGTGCAAAATTAGGCTAG -> GTGTGCAAAATTAGGCTAGG
TCCCAATTTATAACCCACCC -> CCCAATTTATAACCCACCCC
GCCTCTTGGTACAGACCGGC -> CCTCTTGGTACAGACCGGCG
AAACTATGTGACGCCAAAAG -> AACTATGTGACGCCAAAAGG
GTGAGGGCAATCCGCGATTC -> TGAGGGCAATCCGCGATTCT
GTGTTCACGTTTGAAGGTTC -> TGTTCACGTTTGAAGGTTCT
TTACATACGAGGGTGCGAGC -> TACATACGAGGGTGCGAGCT
GATTAGATGTCACCCCGTCC -> ATTAGATGTCACCCCGTCCG
TACCGGGCAAAAAAGGACTC -> ACCGGGCAAAAAAGGACTCG
AAACCATCCATAATACCCTA -> AACCATCCATAATACCCTAC
TTAATCTTCTCAATCACATT -> TAATCTTCTCAATCACATTA
CTCCCTGTCGGCTCTATTAG -> TCCCTGTCGGCTCTATTAGC
GCTTGATCCCAATTTATAAC -> CTTGATCCCAATTTATAACC
GATAGCCCCGGTAGTGCTAT -> ATAGCCCCGGTAGTGCTATA
CACCTTGCACTGGGTGTTCA -> ACCTTGCACTGGGTGTTCAC
AGGTCTAGCCCACTTCTGTC -> GGTCTAGCCCACTTCTGTCA
GAAGGAAGCTACTATGTTAA -> AAGGAAGCTACTATGTTAAT
ATAACCCACCCCCCTTGTAA -> TAACCCACCCCCCTTGTAAC
CTGACTCATAAACTCGAAGC -> TGACTCATAAACTCGAAGCT
TGTTGAGACATGGTCGTGGC -> GTTGAGACATGGTCGTGGCA
CGACTCGGCCTCTTGGTACA -> GACTCGGCCTCTTGGTACAG
CCGTAAAATTCCGATAGCCC -> CGTAAAATTCCGATAGCCCC
TTGAGCATCGAATAGCCCCT -> TGAGCATCGAATAGCCCCTA
ACGGCTGTAACTCTCCCCCT -> CGGCTGTAACTCTCCCCCTG
GCGATTCTGTTCATGAATGG -> CGATTCTGTTCATGAATGGC
GAACCAATACAATTCATTGC -> AACCAATACAATTCATTGCA
GGAAAACTAGGGACTCAGAC -> GAAAACTAGGGACTCAGACT
ATTTATAACCCACCCCCCTT -> TTTATAACCCACCCCCCTTG
TCTTGGTACAGACCGGCGAG -> CTTGGTACAGACCGGCGAGG
GTCAGCGTGACCCAAGTGCT -> TCAGCGTGACCCAAGTGCTG
CTTCGGTCAAAAGCATGTGA -> TTCGGTCAAAAGCATGTGAG
ATTAAAAGCGAGCGTGTAGA -> TTAAAAGCGAGCGTGTAGAG
TATCGTTTCTCTTGCCTGCG -> ATCGTTTCTCTTGCCTGCGA
GATTAAAAGCGAGCGTGTAG -> ATTAAAAGCGAGCGTGTAGA
CAATACAATTCATTGCAGGC -> AATACAATTCATTGCAGGCT
CCAGTACTTCTTAATAGGCC -> CAGTACTTCTTAATAGGCCG
GTAATCCGCTTATAGGAAAC -> TAATCCGCTTATAGGAAACA
CTCGTTGAGCATCGAATAGC -> TCGTTGAGCATCGAATAGCC
CCGGAGAACAGGTATCGTTT -> CGGAGAACAGGTATCGTTTC
CCAATTTATAACCCACCCCC -> CAATTTATAACCCACCCCCC
GTACAGACCGGCGAGGAGTT -> TACAGACCGGCGAGGAGTTG
CCAGCTGACTCATAAACTCG -> CAGCTGACTCATAAACTCGA
GTGGCAACCAGTACTTCTTA -> TGGCAACCAGTACTTCTTAA
AGCGTGTAGAGATACTGGTT -> GCGTGTAGAGATACTGGTTA
ACTATGTTAATCTTCTCAAT -> CTATGTTAATCTTCTCAATC
AGAGATACTGGTTACATACG -> GAGATACTGGTTACATACGA
TTAAACGGCTGTAACTCTCC -> TAAACGGCTGTAACTCTCCC
TGGCTACCGGGCAAAAAAGG -> GGCTACCGGGCAAAAAAGGA
GTGCTGGCCACAAAGGCGTC -> TGCTGGCCACAAAGGCGTCC
CCGGCGAGGAGTTGGGAAAA -> CGGCGAGGAGTTGGGAAAAC
GTTTTACCACCTTGCACTGG -> TTTTACCACCTTGCACTGGG
CTGTTGATCAGATCGGGAGG -> TGTTGATCAGATCGGGAGGT
CCGTGTTGAGACATGGTCGT -> CGTGTTGAGACATGGTCGTG
GTCACCCCGTCCGTAAAATT -> TCACCCCGTCCGTAAAATTC
CCTGAGGCAGCTCTTAAACG -> CTGAGGCAGCTCTTAAACGG
TGAGACATGGTCGTGGCAAC -> GAGACATGGTCGTGGCAACC
TTCACGTTTGAAGGTTCTTC -> TCACGTTTGAAGGTTCTTCC
AACACACAAACGACTCGGCC -> ACACACAAACGACTCGGCCT
TTGTCAAAACTATGTGACGC -> TGTCAAAACTATGTGACGCC
ATATTCCTGAGGCAGCTCTT -> TATTCCTGAGGCAGCTCTTA
ACTTCTGTCACTGGTAAATA -> CTTCTGTCACTGGTAAATAC
TACATACGAGGGTGCGAGCT -> ACATACGAGGGTGCGAGCTG
GAGAACAGGTATCGTTTCTC -> AGAACAGGTATCGTTTCTCT
AAAATTAGGCTAGGCCGCCT -> AAATTAGGCTAGGCCGCCTT
AAACTCGAAGCTCCCTGTCG -> AACTCGAAGCTCCCTGTCGG
CCTGTTGATCAGATCGGGAG -> CTGTTGATCAGATCGGGAGG
CCTTGTAACTCCCGGAGAAC -> CTTGTAACTCCCGGAGAACA
TTGAGACATGGTCGTGGCAA -> TGAGACATGGTCGTGGCAAC
AGGTATCGTTTCTCTTGCCT -> GGTATCGTTTCTCTTGCCTG
TCTCCCCCTGTTGATCAGAT -> CTCCCCCTGTTGATCAGATC
CTGCGACTGAAGATAAGCAG -> TGCGACTGAAGATAAGCAGT
ACATACGAGGGTGCGAGCTG -> CATACGAGGGTGCGAGCTGT
TGGAGGTCACTCTGCTAATG -> GGAGGTCACTCTGCTAATGG
CAGTGCACGGTCCCGTGTTG -> AGTGCACGGTCCCGTGTTGA
CTAATTCAGAAACCATCCAT -> TAATTCAGAAACCATCCATA
AAACGGCTGTAACTCTCCCC -> AACGGCTGTAACTCTCCCCC
GTCAAAAGCATGTGAGTAGC -> TCAAAAGCATGTGAGTAGCG
TGATCCCAATTTATAACCCA -> GATCCCAATTTATAACCCAC
GAGGTCACTCTGCTAATGGA -> AGGTCACTCTGCTAATGGAA
CATCATGGTCAGCGTGACCC -> ATCATGGTCAGCGTGACCCA
AGCATTATCGTTTTACCACC -> GCATTATCGTTTTACCACCT
GAGGAGTTGGGAAAACTAGG -> AGGAGTTGGGAAAACTAGGG
CCTATCAGATTAGATGTCAC -> CTATCAGATTAGATGTCACC
TCGGCCTCTTGGTACAGACC -> CGGCCTCTTGGTACAGACCG
ATACTGGTTACATACGAGGG -> TACTGGTTACATACGAGGGT
GCTGGCCACAAAGGCGTCCG -> CTGGCCACAAAGGCGTCCGG
ATCAGATTAGATGTCACCCC -> TCAGATTAGATGTCACCCCG
CGGAGCAATCTCACACCCGC -> GGAGCAATCTCACACCCGCT
GGAGTTGGGAAAACTAGGGA -> GAGTTGGGAAAACTAGGGAC
AAGGCGTCCGGACAGGTCTA -> AGGCGTCCGGACAGGTCTAG
GACCGGCGAGGAGTTGGGAA -> ACCGGCGAGGAGTTGGGAAA
CAATCTCACACCCGCTTGAT -> AATCTCACACCCGCTTGATC
GGCCAAGTGGGACGAAGTAT -> GCCAAGTGGGACGAAGTATG
TAGCCCACTTCTGTCACTGG -> AGCCCACTTCTGTCACTGGT
TCATTGCAGGCTGATCCGAG -> CATTGCAGGCTGATCCGAGC
ATTGCAGGCTGATCCGAGCA -> TTGCAGGCTGATCCGAGCAT
GACCCAAGTGCTGGCCACAA -> ACCCAAGTGCTGGCCACAAA
AACGGCTGTAACTCTCCCCC -> ACGGCTGTAACTCTCCCCCT
TAACTCCCGGAGAACAGGTA -> AACTCCCGGAGAACAGGTAT
ACTCGAAGCTCCCTGTCGGC -> CTCGAAGCTCCCTGTCGGCT
TACAGTGAGGGCAATCCGCG -> ACAGTGAGGGCAATCCGCGA
GGTCAGCGTGACCCAAGTGC -> GTCAGCGTGACCCAAGTGCT
CTCTTGCCTGCGACTGAAGA -> TCTTGCCTGCGACTGAAGAT
TAGGCCGTACAGTGAGGGCA -> AGGCCGTACAGTGAGGGCAA
CTGTCGTCTCGTTGGTGAGC -> TGTCGTCTCGTTGGTGAGCA
TCGTTTCTCTTGCCTGCGAC -> CGTTTCTCTTGCCTGCGACT
TCGGGAGGTACGTCATGTGA -> CGGGAGGTACGTCATGTGAG
TCCGGACAGGTCTAGCCCAC -> CCGGACAGGTCTAGCCCACT
CCGTCCGTAAAATTCCGATA -> CGTCCGTAAAATTCCGATAG
TGAGGCAGCTCTTAAACGGC -> GAGGCAGCTCTTAAACGGCT
AGTGCACGGTCCCGTGTTGA -> GTGCACGGTCCCGTGTTGAG
ACATTTTGTCAAAACTATGT -> CATTTTGTCAAAACTATGTG
ACAGTGAGGGCAATCCGCGA -> CAGTGAGGGCAATCCGCGAT
CTGAAGATAAGCAGTGCACG -> TGAAGATAAGCAGTGCACGG
CTTCTCAATCACATTATGAC -> TTCTCAATCACATTATGACA
GCGACTGAAGATAAGCAGTG -> CGACTGAAGATAAGCAGTGC
CCCGTGTTGAGACATGGTCG -> CCGTGTTGAGACATGGTCGT
CAGTGAGGGCAATCCGCGAT -> AGTGAGGGCAATCCGCGATT
CTCTGCTAATGGAACCAATA -> TCTGCTAATGGAACCAATAC
TGGCCACAAAGGCGTCCGGA -> GGCCACAAAGGCGTCCGGAC
GTTAATCTTCTCAATCACAT -> TTAATCTTCTCAATCACATT
GCACGGTCCCGTGTTGAGAC -> CACGGTCCCGTGTTGAGACA
TGGTACAGACCGGCGAGGAG -> GGTACAGACCGGCGAGGAGT
TAGCGATGTCGGATACAGCA -> AGCGATGTCGGATACAGCAG
GCCCAGCTGACTCATAAACT -> CCCAGCTGACTCATAAACTC
CCGAGCATTATCGTTTTACC -> CGAGCATTATCGTTTTACCA
ACTTCGGTCAAAAGCATGTG -> CTTCGGTCAAAAGCATGTGA
AGCTACTATGTTAATCTTCT -> GCTACTATGTTAATCTTCTC
GAGGGTGCGAGCTGTCGTCT -> AGGGTGCGAGCTGTCGTCTC
TGTTGATCAGATCGGGAGGT -> GTTGATCAGATCGGGAGGTA
TCACACCCGCTTGATCCCAA -> CACACCCGCTTGATCCCAAT
GAGATACTGGTTACATACGA -> AGATACTGGTTACATACGAG
GAGTAATCCGCTTATAGGAA -> AGTAATCCGCTTATAGGAAA
GTTGAGACATGGTCGTGGCA -> TTGAGACATGGTCGTGGCAA
CGCGATTCTGTTCATGAATG -> GCGATTCTGTTCATGAATGG
CCGCTTATAGGAAACACACA -> CGCTTATAGGAAACACACAA
TCCGCATATTCCTGAGGCAG -> CCGCATATTCCTGAGGCAGC
AAAGCGAGCGTGTAGAGATA -> AAGCGAGCGTGTAGAGATAC
AGCGATGTCGGATACAGCAG -> GCGATGTCGGATACAGCAGG
GGTGTTCACGTTTGAAGGTT -> GTGTTCACGTTTGAAGGTTC
ACTGAAGATAAGCAGTGCAC -> CTGAAGATAAGCAGTGCACG
AATTTATAACCCACCCCCCT -> ATTTATAACCCACCCCCCTT
AGTGCTATACCAAACTCGGT -> GTGCTATACCAAACTCGGTC
TGCGAGCTGTCGTCTCGTTG -> GCGAGCTGTCGTCTCGTTGG
TCTTCTCAATCACATTATGA -> CTTCTCAATCACATTATGAC
AGATGTCACCCCGTCCGTAA -> GATGTCACCCCGTCCGTAAA
CTCTTAAACGGCTGTAACTC -> TCTTAAACGGCTGTAACTCT
TATAGGAAACACACAAACGA -> ATAGGAAACACACAAACGAC
CGTTGGTGAGCACGCCCAGC -> GTTGGTGAGCACGCCCAGCT
AGCAATCTCACACCCGCTTG -> GCAATCTCACACCCGCTTGA
AACAGGTATCGTTTCTCTTG -> ACAGGTATCGTTTCTCTTGC
AGTGCTGGCCACAAAGGCGT -> GTGCTGGCCACAAAGGCGTC
CGGGAGGTACGTCATGTGAG -> GGGAGGTACGTCATGTGAGG
ATTAGATGTCACCCCGTCCG -> TTAGATGTCACCCCGTCCGT
GATAAGCAGTGCACGGTCCC -> ATAAGCAGTGCACGGTCCCG
AGAAACCATCCATAATACCC -> GAAACCATCCATAATACCCT
TGTCGGATACAGCAGGCCAT -> GTCGGATACAGCAGGCCATT
ACAAACGACTCGGCCTCTTG -> CAAACGACTCGGCCTCTTGG
GAGCAATCTCACACCCGCTT -> AGCAATCTCACACCCGCTTG
GTATGGAAGGAAGCTACTAT -> TATGGAAGGAAGCTACTATG
CGCTTGATCCCAATTTATAA -> GCTTGATCCCAATTTATAAC
GCAGGCTGATCCGAGCATTA -> CAGGCTGATCCGAGCATTAT
GCACTGGGTGTTCACGTTTG -> CACTGGGTGTTCACGTTTGA
CAAAATTAGGCTAGGCCGCC -> AAAATTAGGCTAGGCCGCCT
ATAATACCCTACATAATCCA -> TAATACCCTACATAATCCAT
CCACAAAGGCGTCCGGACAG -> CACAAAGGCGTCCGGACAGG
CTCGAAGCTCCCTGTCGGCT -> TCGAAGCTCCCTGTCGGCTC
AAAGCATGTGAGTAGCGATG -> AAGCATGTGAGTAGCGATGT
GTATCGTTTCTCTTGCCTGC -> TATCGTTTCTCTTGCCTGCG
AGACCGGCGAGGAGTTGGGA -> GACCGGCGAGGAGTTGGGAA
ACAATTCATTGCAGGCTGAT -> CAATTCATTGCAGGCTGATC
TTTCTCTTGCCTGCGACTGA -> TTCTCTTGCCTGCGACTGAA
TAAAAGCGAGCGTGTAGAGA -> AAAAGCGAGCGTGTAGAGAT
GCTATACCAAACTCGGTCCT -> CTATACCAAACTCGGTCCTC
CCCCTATCAGATTAGATGTC -> CCCTATCAGATTAGATGTCA
ACTCGTTGAGCATCGAATAG -> CTCGTTGAGCATCGAATAGC
GGACAGGTCTAGCCCACTTC -> GACAGGTCTAGCCCACTTCT
CATAATACCCTACATAATCC -> ATAATACCCTACATAATCCA
CAATCCGCGATTCTGTTCAT -> AATCCGCGATTCTGTTCATG
TCTAATTCAGAAACCATCCA -> CTAATTCAGAAACCATCCAT
GGCCGCCTTAAGTGTACTTC -> GCCGCCTTAAGTGTACTTCG
TAGGCCGCCTTAAGTGTACT -> AGGCCGCCTTAAGTGTACTT
GAGCATCGAATAGCCCCTAT -> AGCATCGAATAGCCCCTATC
GGTGAGCACGCCCAGCTGAC -> GTGAGCACGCCCAGCTGACT
CGAGGGTGCGAGCTGTCGTC -> GAGGGTGCGAGCTGTCGTCT
TCTCAATCACATTATGACAT -> CTCAATCACATTATGACATC
CGGTCCTCCGCATATTCCTG -> GGTCCTCCGCATATTCCTGA
ATCGTTTCTCTTGCCTGCGA -> TCGTTTCTCTTGCCTGCGAC
TGAATGGCTACCGGGCAAAA -> GAATGGCTACCGGGCAAAAA
GCAATCCGCGATTCTGTTCA -> CAATCCGCGATTCTGTTCAT
ATCAGATCGGGAGGTACGTC -> TCAGATCGGGAGGTACGTCA
ATCCCAATTTATAACCCACC -> TCCCAATTTATAACCCACCC
GCCATTGGAGGTCACTCTGC -> CCATTGGAGGTCACTCTGCT
CTTCTGTCACTGGTAAATAC -> TTCTGTCACTGGTAAATACG
CCTCTTGGTACAGACCGGCG -> CTCTTGGTACAGACCGGCGA
GGTAACATTTTGTCAAAACT -> GTAACATTTTGTCAAAACTA
CCCTGTCGGCTCTATTAGCC -> CCTGTCGGCTCTATTAGCCG
GATGTCACCCCGTCCGTAAA -> ATGTCACCCCGTCCGTAAAA
CCGCCTTAAGTGTACTTCGG -> CGCCTTAAGTGTACTTCGGT
TCAATCACATTATGACATCA -> CAATCACATTATGACATCAT
GGCGAGGAGTTGGGAAAACT -> GCGAGGAGTTGGGAAAACTA
CAGGTCTAGCCCACTTCTGT -> AGGTCTAGCCCACTTCTGTC
AACCCACCCCCCTTGTAACT -> ACCCACCCCCCTTGTAACTC
AACCAGTACTTCTTAATAGG -> ACCAGTACTTCTTAATAGGC
TTGATCCCAATTTATAACCC -> TGATCCCAATTTATAACCCA
CAGATTAGATGTCACCCCGT -> AGATTAGATGTCACCCCGTC
GAAGTATGGAAGGAAGCTAC -> AAGTATGGAAGGAAGCTACT
CCCCCTTGTAACTCCCGGAG -> CCCCTTGTAACTCCCGGAGA
TACCCTACATAATCCATCAC -> ACCCTACATAATCCATCACT
CTACCGGGCAAAAAAGGACT -> TACCGGGCAAAAAAGGACTC
TCACTGGTAAATACGAGTAA -> CACTGGTAAATACGAGTAAT
AATTCAGAAACCATCCATAA -> ATTCAGAAACCATCCATAAT
CCATCACTTGATTAAAAGCG -> CATCACTTGATTAAAAGCGA
GAGGGCAATCCGCGATTCTG -> AGGGCAATCCGCGATTCTGT
CAGACTCGGGGTAACATTTT -> AGACTCGGGGTAACATTTTG
TTCTTCCGGAGCAATCTCAC -> TCTTCCGGAGCAATCTCACA
TCAGCGTGACCCAAGTGCTG -> CAGCGTGACCCAAGTGCTGG
TCAGATTAGATGTCACCCCG -> CAGATTAGATGTCACCCCGT
GCCACAAAGGCGTCCGGACA -> CCACAAAGGCGTCCGGACAG
CAAGTGGGACGAAGTATGGA -> AAGTGGGACGAAGTATGGAA
ACTCGGGGTAACATTTTGTC -> CTCGGGGTAACATTTTGTCA
GAGACATGGTCGTGGCAACC -> AGACATGGTCGTGGCAACCA
ACAAAGGCGTCCGGACAGGT -> CAAAGGCGTCCGGACAGGTC
ATGTGAGGCCAAGTGGGACG -> TGTGAGGCCAAGTGGGACGA
CCTACATAATCCATCACTTG -> CTACATAATCCATCACTTGA
GTTGGTGAGCACGCCCAGCT -> TTGGTGAGCACGCCCAGCTG
GCCCCTATCAGATTAGATGT -> CCCCTATCAGATTAGATGTC
CATCGAATAGCCCCTATCAG -> ATCGAATAGCCCCTATCAGA
GTGAGTAGCGATGTCGGATA -> TGAGTAGCGATGTCGGATAC
ACAGGTATCGTTTCTCTTGC -> CAGGTATCGTTTCTCTTGCC
TAAACTCGAAGCTCCCTGTC -> AAACTCGAAGCTCCCTGTCG
GTAACTCTCCCCCTGTTGAT -> TAACTCTCCCCCTGTTGATC
TACGAGTAATCCGCTTATAG -> ACGAGTAATCCGCTTATAGG
TGTCAAAACTATGTGACGCC -> GTCAAAACTATGTGACGCCA
TTGCAGGCTGATCCGAGCAT -> TGCAGGCTGATCCGAGCATT
TACAGACCGGCGAGGAGTTG -> ACAGACCGGCGAGGAGTTGG
CGTTTGAAGGTTCTTCCGGA -> GTTTGAAGGTTCTTCCGGAG
TGTGAGGCCAAGTGGGACGA -> GTGAGGCCAAGTGGGACGAA
AGCCCACTTCTGTCACTGGT -> GCCCACTTCTGTCACTGGTA
ACATGGTCGTGGCAACCAGT -> CATGGTCGTGGCAACCAGTA
GTTCTTCCGGAGCAATCTCA -> TTCTTCCGGAGCAATCTCAC
CCCCCCTTGTAACTCCCGGA -> CCCCCTTGTAACTCCCGGAG
AAGATAAGCAGTGCACGGTC -> AGATAAGCAGTGCACGGTCC
CAAAAGGCGTTCTAATTCAG -> AAAAGGCGTTCTAATTCAGA
AGGGCAATCCGCGATTCTGT -> GGGCAATCCGCGATTCTGTT
AGATCGGGAGGTACGTCATG -> GATCGGGAGGTACGTCATGT
GGCTACCGGGCAAAAAAGGA -> GCTACCGGGCAAAAAAGGAC
AGTAGCGATGTCGGATACAG -> GTAGCGATGTCGGATACAGC
ATACGAGTAATCCGCTTATA -> TACGAGTAATCCGCTTATAG
CGTACAGTGAGGGCAATCCG -> GTACAGTGAGGGCAATCCGC
GGCCGTACAGTGAGGGCAAT -> GCCGTACAGTGAGGGCAATC
CAGGCTGATCCGAGCATTAT -> AGGCTGATCCGAGCATTATC
TTATGACATCATGGTCAGCG -> TATGACATCATGGTCAGCGT
CAATCACATTATGACATCAT -> AATCACATTATGACATCATG
AATTCCGATAGCCCCGGTAG -> ATTCCGATAGCCCCGGTAGT
TTGGTGAGCACGCCCAGCTG -> TGGTGAGCACGCCCAGCTGA
CTCCGCATATTCCTGAGGCA -> TCCGCATATTCCTGAGGCAG
CTCCCCCTGTTGATCAGATC -> TCCCCCTGTTGATCAGATCG
TCGAATAGCCCCTATCAGAT -> CGAATAGCCCCTATCAGATT
TTATAGGAAACACACAAACG -> TATAGGAAACACACAAACGA
CCACCCCCCTTGTAACTCCC -> CACCCCCCTTGTAACTCCCG
CATGTGAGTAGCGATGTCGG -> ATGTGAGTAGCGATGTCGGA
TCTGTCACTGGTAAATACGA -> CTGTCACTGGTAAATACGAG
AAACGACTCGGCCTCTTGGT -> AACGACTCGGCCTCTTGGTA
CGGCTGTAACTCTCCCCCTG -> GGCTGTAACTCTCCCCCTGT
TGGCAACCAGTACTTCTTAA -> GGCAACCAGTACTTCTTAAT
AAGTGGGACGAAGTATGGAA -> AGTGGGACGAAGTATGGAAG
GTTGGGAAAACTAGGGACTC -> TTGGGAAAACTAGGGACTCA
GGCTGATCCGAGCATTATCG -> GCTGATCCGAGCATTATCGT
CTCAGACTCGGGGTAACATT -> TCAGACTCGGGGTAACATTT
CATGTGAGGCCAAGTGGGAC -> ATGTGAGGCCAAGTGGGACG
AGGAGTTGGGAAAACTAGGG -> GGAGTTGGGAAAACTAGGGA
GAGGCAGCTCTTAAACGGCT -> AGGCAGCTCTTAAACGGCTG
CCAAAAGGCGTTCTAATTCA -> CAAAAGGCGTTCTAATTCAG
ATCTCACACCCGCTTGATCC -> TCTCACACCCGCTTGATCCC
TCAGACTCGGGGTAACATTT -> CAGACTCGGGGTAACATTTT
CTTGTAACTCCCGGAGAACA -> TTGTAACTCCCGGAGAACAG
GCCTGCGACTGAAGATAAGC -> CCTGCGACTGAAGATAAGCA
AAAAGCGAGCGTGTAGAGAT -> AAAGCGAGCGTGTAGAGATA
TCGGTCAAAAGCATGTGAGT -> CGGTCAAAAGCATGTGAGTA
CAGATCGGGAGGTACGTCAT -> AGATCGGGAGGTACGTCATG
TCAAAAGCATGTGAGTAGCG -> CAAAAGCATGTGAGTAGCGA
GGTCGTGGCAACCAGTACTT -> GTCGTGGCAACCAGTACTTC
CGAAGTATGGAAGGAAGCTA -> GAAGTATGGAAGGAAGCTAC
GAAGCTCCCTGTCGGCTCTA -> AAGCTCCCTGTCGGCTCTAT
TGGTTACATACGAGGGTGCG -> GGTTACATACGAGGGTGCGA
CACTTGATTAAAAGCGAGCG -> ACTTGATTAAAAGCGAGCGT
TTTGTCAAAACTATGTGACG -> TTGTCAAAACTATGTGACGC
CGGATACAGCAGGCCATTGG -> GGATACAGCAGGCCATTGGA
TCCTCCGCATATTCCTGAGG -> CCTCCGCATATTCCTGAGGC
TGAGGCCAAGTGGGACGAAG -> GAGGCCAAGTGGGACGAAGT
AACTCGAAGCTCCCTGTCGG -> ACTCGAAGCTCCCTGTCGGC
CACCCCGTCCGTAAAATTCC -> ACCCCGTCCGTAAAATTCCG
TCCCGGAGAACAGGTATCGT -> CCCGGAGAACAGGTATCGTT
CCGCGATTCTGTTCATGAAT -> CGCGATTCTGTTCATGAATG
AGCATCGAATAGCCCCTATC -> GCATCGAATAGCCCCTATCA
GTGTTGAGACATGGTCGTGG -> TGTTGAGACATGGTCGTGGC
TAATCTTCTCAATCACATTA -> AATCTTCTCAATCACATTAT
TTCTCAATCACATTATGACA -> TCTCAATCACATTATGACAT
TATACCAAACTCGGTCCTCC -> ATACCAAACTCGGTCCTCCG
AAATTAGGCTAGGCCGCCTT -> AATTAGGCTAGGCCGCCTTA
GGACTCAGACTCGGGGTAAC -> GACTCAGACTCGGGGTAACA
AAGCTCCCTGTCGGCTCTAT -> AGCTCCCTGTCGGCTCTATT
CCATAATACCCTACATAATC -> CATAATACCCTACATAATCC
ACTAGGGACTCAGACTCGGG -> CTAGGGACTCAGACTCGGGG
AGCACGCCCAGCTGACTCAT -> GCACGCCCAGCTGACTCATA
GTCCTCCGCATATTCCTGAG -> TCCTCCGCATATTCCTGAGG
CTATACCAAACTCGGTCCTC -> TATACCAAACTCGGTCCTCC
GGTTCTTCCGGAGCAATCTC -> GTTCTTCCGGAGCAATCTCA
CGTTTCTCTTGCCTGCGACT -> GTTTCTCTTGCCTGCGACTG
AGCCCCGGTAGTGCTATACC -> GCCCCGGTAGTGCTATACCA
GACTCGGGGTAACATTTTGT -> ACTCGGGGTAACATTTTGTC
AGACTCGGGGTAACATTTTG -> GACTCGGGGTAACATTTTGT
AGATAAGCAGTGCACGGTCC -> GATAAGCAGTGCACGGTCCC
CGAGTAATCCGCTTATAGGA -> GAGTAATCCGCTTATAGGAA
CTATCAGATTAGATGTCACC -> TATCAGATTAGATGTCACCC
GCTAGGCCGCCTTAAGTGTA -> CTAGGCCGCCTTAAGTGTAC
GGCAACCAGTACTTCTTAAT -> GCAACCAGTACTTCTTAATA
GACTCGTTGAGCATCGAATA -> ACTCGTTGAGCATCGAATAG
GTAGAGATACTGGTTACATA -> TAGAGATACTGGTTACATAC
CGATGTCGGATACAGCAGGC -> GATGTCGGATACAGCAGGCC
AGATTAGATGTCACCCCGTC -> GATTAGATGTCACCCCGTCC
ATCGTTTTACCACCTTGCAC -> TCGTTTTACCACCTTGCACT
GGAGGTCACTCTGCTAATGG -> GAGGTCACTCTGCTAATGGA
GATTCTGTTCATGAATGGCT -> ATTCTGTTCATGAATGGCTA
CAGCTCTTAAACGGCTGTAA -> AGCTCTTAAACGGCTGTAAC
ATCACTTGATTAAAAGCGAG -> TCACTTGATTAAAAGCGAGC
ACATAATCCATCACTTGATT -> CATAATCCATCACTTGATTA
CTCAATCACATTATGACATC -> TCAATCACATTATGACATCA
ACGCCAAAAGGCGTTCTAAT -> CGCCAAAAGGCGTTCTAATT
GTTTGAAGGTTCTTCCGGAG -> TTTGAAGGTTCTTCCGGAGC
AACTCCCGGAGAACAGGTAT -> ACTCCCGGAGAACAGGTATC
GGCCATTGGAGGTCACTCTG -> GCCATTGGAGGTCACTCTGC
GAGCACGCCCAGCTGACTCA -> AGCACGCCCAGCTGACTCAT
ATTATCGTTTTACCACCTTG -> TTATCGTTTTACCACCTTGC
TCATGAATGGCTACCGGGCA -> CATGAATGGCTACCGGGCAA
CAAAACTATGTGACGCCAAA -> AAAACTATGTGACGCCAAAA
ATAGGCCGTACAGTGAGGGC -> TAGGCCGTACAGTGAGGGCA
ATTATGACATCATGGTCAGC -> TTATGACATCATGGTCAGCG
CGGTCAAAAGCATGTGAGTA -> GGTCAAAAGCATGTGAGTAG
ACCAAACTCGGTCCTCCGCA -> CCAAACTCGGTCCTCCGCAT
AGACATGGTCGTGGCAACCA -> GACATGGTCGTGGCAACCAG
CACCCCCCTTGTAACTCCCG -> ACCCCCCTTGTAACTCCCGG
AAGCGAGCGTGTAGAGATAC -> AGCGAGCGTGTAGAGATACT
CTGTTCATGAATGGCTACCG -> TGTTCATGAATGGCTACCGG
TAGTGCTATACCAAACTCGG -> AGTGCTATACCAAACTCGGT
TTTTGTCAAAACTATGTGAC -> TTTGTCAAAACTATGTGACG
AGGTACGTCATGTGAGGCCA -> GGTACGTCATGTGAGGCCAA
ACCAGTACTTCTTAATAGGC -> CCAGTACTTCTTAATAGGCC
TCATGTGAGGCCAAGTGGGA -> CATGTGAGGCCAAGTGGGAC
GTTCACGTTTGAAGGTTCTT -> TTCACGTTTGAAGGTTCTTC
CCGATAGCCCCGGTAGTGCT -> CGATAGCCCCGGTAGTGCTA
TCCCCCTGTTGATCAGATCG -> CCCCCTGTTGATCAGATCGG
GACGCCAAAAGGCGTTCTAA -> ACGCCAAAAGGCGTTCTAAT
CCCTGTTGATCAGATCGGGA -> CCTGTTGATCAGATCGGGAG
CGGGCAAAAAAGGACTCGTT -> GGGCAAAAAAGGACTCGTTG
CCCACTTCTGTCACTGGTAA -> CCACTTCTGTCACTGGTAAA
ATCATGGTCAGCGTGACCCA -> TCATGGTCAGCGTGACCCAA
GTGACGCCAAAAGGCGTTCT -> TGACGCCAAAAGGCGTTCTA
CCGCTTGATCCCAATTTATA -> CGCTTGATCCCAATTTATAA
GGTAGTGCTATACCAAACTC -> GTAGTGCTATACCAAACTCG
GGAGGTACGTCATGTGAGGC -> GAGGTACGTCATGTGAGGCC
TCACATTATGACATCATGGT -> CACATTATGACATCATGGTC
ACACAAACGACTCGGCCTCT -> CACAAACGACTCGGCCTCTT
GAACAGGTATCGTTTCTCTT -> AACAGGTATCGTTTCTCTTG
TCAGAAACCATCCATAATAC -> CAGAAACCATCCATAATACC
GGGCAATCCGCGATTCTGTT -> GGCAATCCGCGATTCTGTTC
TTAATAGGCCGTACAGTGAG -> TAATAGGCCGTACAGTGAGG
GACAGGTCTAGCCCACTTCT -> ACAGGTCTAGCCCACTTCTG
TACCAAACTCGGTCCTCCGC -> ACCAAACTCGGTCCTCCGCA
GTGCAAAATTAGGCTAGGCC -> TGCAAAATTAGGCTAGGCCG
ACTCATAAACTCGAAGCTCC -> CTCATAAACTCGAAGCTCCC
CACTCTGCTAATGGAACCAA -> ACTCTGCTAATGGAACCAAT
GAAACACACAAACGACTCGG -> AAACACACAAACGACTCGGC
CCGTACAGTGAGGGCAATCC -> CGTACAGTGAGGGCAATCCG
TAGGGACTCAGACTCGGGGT -> AGGGACTCAGACTCGGGGTA
ATCTTCTCAATCACATTATG -> TCTTCTCAATCACATTATGA
ACGAGGGTGCGAGCTGTCGT -> CGAGGGTGCGAGCTGTCGTC
GCCTTAAGTGTACTTCGGTC -> CCTTAAGTGTACTTCGGTCA
CTGTAACTCTCCCCCTGTTG -> TGTAACTCTCCCCCTGTTGA
AGGGACTCAGACTCGGGGTA -> GGGACTCAGACTCGGGGTAA
AGCATGTGAGTAGCGATGTC -> GCATGTGAGTAGCGATGTCG
TTCTCTTGCCTGCGACTGAA -> TCTCTTGCCTGCGACTGAAG
GCTACTATGTTAATCTTCTC -> CTACTATGTTAATCTTCTCA
GCCAAGTGGGACGAAGTATG -> CCAAGTGGGACGAAGTATGG
TGAAGGTTCTTCCGGAGCAA -> GAAGGTTCTTCCGGAGCAAT
GGTCCTCCGCATATTCCTGA -> GTCCTCCGCATATTCCTGAG
CCGCATATTCCTGAGGCAGC -> CGCATATTCCTGAGGCAGCT
CACGCCCAGCTGACTCATAA -> ACGCCCAGCTGACTCATAAA
AAAGGACTCGTTGAGCATCG -> AAGGACTCGTTGAGCATCGA
AAGCTACTATGTTAATCTTC -> AGCTACTATGTTAATCTTCT
TCCTGAGGCAGCTCTTAAAC -> CCTGAGGCAGCTCTTAAACG
AATCCATCACTTGATTAAAA -> ATCCATCACTTGATTAAAAG
GATCCGAGCATTATCGTTTT -> ATCCGAGCATTATCGTTTTA
CCAATACAATTCATTGCAGG -> CAATACAATTCATTGCAGGC
CCGGAGCAATCTCACACCCG -> CGGAGCAATCTCACACCCGC
CGATTCTGTTCATGAATGGC -> GATTCTGTTCATGAATGGCT
CCTTGCACTGGGTGTTCACG -> CTTGCACTGGGTGTTCACGT
TCACTCTGCTAATGGAACCA -> CACTCTGCTAATGGAACCAA
GATACTGGTTACATACGAGG -> ATACTGGTTACATACGAGGG
TCCGCGATTCTGTTCATGAA -> CCGCGATTCTGTTCATGAAT
GGCTGTAACTCTCCCCCTGT -> GCTGTAACTCTCCCCCTGTT
ATCCGCGATTCTGTTCATGA -> TCCGCGATTCTGTTCATGAA
ATTCATTGCAGGCTGATCCG -> TTCATTGCAGGCTGATCCGA
TCGGTCCTCCGCATATTCCT -> CGGTCCTCCGCATATTCCTG
AGAACAGGTATCGTTTCTCT -> GAACAGGTATCGTTTCTCTT
GCGTGTAGAGATACTGGTTA -> CGTGTAGAGATACTGGTTAC
CCCTTGTAACTCCCGGAGAA -> CCTTGTAACTCCCGGAGAAC
CATGAATGGCTACCGGGCAA -> ATGAATGGCTACCGGGCAAA
CCTTAAGTGTACTTCGGTCA -> CTTAAGTGTACTTCGGTCAA
AGGCCGTACAGTGAGGGCAA -> GGCCGTACAGTGAGGGCAAT
AGGCCATTGGAGGTCACTCT -> GGCCATTGGAGGTCACTCTG
CGGTAGTGCTATACCAAACT -> GGTAGTGCTATACCAAACTC
TCGTTGGTGAGCACGCCCAG -> CGTTGGTGAGCACGCCCAGC
GGATACAGCAGGCCATTGGA -> GATACAGCAGGCCATTGGAG
CACATTATGACATCATGGTC -> ACATTATGACATCATGGTCA
CACAAAGGCGTCCGGACAGG -> ACAAAGGCGTCCGGACAGGT
GGTCAAAAGCATGTGAGTAG -> GTCAAAAGCATGTGAGTAGC
GTGCGAGCTGTCGTCTCGTT -> TGCGAGCTGTCGTCTCGTTG
TGGTGAGCACGCCCAGCTGA -> GGTGAGCACGCCCAGCTGAC
GCTGACTCATAAACTCGAAG -> CTGACTCATAAACTCGAAGC
ATCACATTATGACATCATGG -> TCACATTATGACATCATGGT
ACAGACCGGCGAGGAGTTGG -> CAGACCGGCGAGGAGTTGGG
TGCTAATGGAACCAATACAA -> GCTAATGGAACCAATACAAT
GAGGCCAAGTGGGACGAAGT -> AGGCCAAGTGGGACGAAGTA
ACGACTCGGCCTCTTGGTAC -> CGACTCGGCCTCTTGGTACA
TCGTCTCGTTGGTGAGCACG -> CGTCTCGTTGGTGAGCACGC
AAAACTAGGGACTCAGACTC -> AAACTAGGGACTCAGACTCG
GTGAGCACGCCCAGCTGACT -> TGAGCACGCCCAGCTGACTC
TCCGGAGCAATCTCACACCC -> CCGGAGCAATCTCACACCCG
GCAACCAGTACTTCTTAATA -> CAACCAGTACTTCTTAATAG
GGTCACTCTGCTAATGGAAC -> GTCACTCTGCTAATGGAACC
GCTTATAGGAAACACACAAA -> CTTATAGGAAACACACAAAC
TCGTTGAGCATCGAATAGCC -> CGTTGAGCATCGAATAGCCC
GGTTACATACGAGGGTGCGA -> GTTACATACGAGGGTGCGAG
TGCAGGCTGATCCGAGCATT -> GCAGGCTGATCCGAGCATTA
CCATCCATAATACCCTACAT -> CATCCATAATACCCTACATA
CTATGTGACGCCAAAAGGCG -> TATGTGACGCCAAAAGGCGT
TGGTCAGCGTGACCCAAGTG -> GGTCAGCGTGACCCAAGTGC
AGGGTGCGAGCTGTCGTCTC -> GGGTGCGAGCTGTCGTCTCG
GTACGTCATGTGAGGCCAAG -> TACGTCATGTGAGGCCAAGT
TGGAACCAATACAATTCATT -> GGAACCAATACAATTCATTG
ATTGGAGGTCACTCTGCTAA -> TTGGAGGTCACTCTGCTAAT
AACTCTCCCCCTGTTGATCA -> ACTCTCCCCCTGTTGATCAG
TAATAGGCCGTACAGTGAGG -> AATAGGCCGTACAGTGAGGG
CGGAGAACAGGTATCGTTTC -> GGAGAACAGGTATCGTTTCT
GTCACTCTGCTAATGGAACC -> TCACTCTGCTAATGGAACCA
GACTGAAGATAAGCAGTGCA -> ACTGAAGATAAGCAGTGCAC
CGATAGCCCCGGTAGTGCTA -> GATAGCCCCGGTAGTGCTAT
GCTAATGGAACCAATACAAT -> CTAATGGAACCAATACAATT
GTGCTATACCAAACTCGGTC -> TGCTATACCAAACTCGGTCC
ATGTTAATCTTCTCAATCAC -> TGTTAATCTTCTCAATCACA
CATTATCGTTTTACCACCTT -> ATTATCGTTTTACCACCTTG
TGCTGGCCACAAAGGCGTCC -> GCTGGCCACAAAGGCGTCCG
CTTGCACTGGGTGTTCACGT -> TTGCACTGGGTGTTCACGTT
ACACACAAACGACTCGGCCT -> CACACAAACGACTCGGCCTC
CTTCTTAATAGGCCGTACAG -> TTCTTAATAGGCCGTACAGT
CGTAAAATTCCGATAGCCCC -> GTAAAATTCCGATAGCCCCG
CATAAACTCGAAGCTCCCTG -> ATAAACTCGAAGCTCCCTGT
ATAGGAAACACACAAACGAC -> TAGGAAACACACAAACGACT
GACATCATGGTCAGCGTGAC -> ACATCATGGTCAGCGTGACC
CGGTCCCGTGTTGAGACATG -> GGTCCCGTGTTGAGACATGG
TGAGTAGCGATGTCGGATAC -> GAGTAGCGATGTCGGATACA
CTAGGGACTCAGACTCGGGG -> TAGGGACTCAGACTCGGGGT
CTGGGTGTTCACGTTTGAAG -> TGGGTGTTCACGTTTGAAGG
GGCAGCTCTTAAACGGCTGT -> GCAGCTCTTAAACGGCTGTA
ATACAATTCATTGCAGGCTG -> TACAATTCATTGCAGGCTGA
TTGATTAAAAGCGAGCGTGT -> TGATTAAAAGCGAGCGTGTA
GAATGGCTACCGGGCAAAAA -> AATGGCTACCGGGCAAAAAA
GTAAAATTCCGATAGCCCCG -> TAAAATTCCGATAGCCCCGG
AGCCCCTATCAGATTAGATG -> GCCCCTATCAGATTAGATGT
CGAGCATTATCGTTTTACCA -> GAGCATTATCGTTTTACCAC
GCTGATCCGAGCATTATCGT -> CTGATCCGAGCATTATCGTT
CTGCTAATGGAACCAATACA -> TGCTAATGGAACCAATACAA
ATGGTCAGCGTGACCCAAGT -> TGGTCAGCGTGACCCAAGTG
TTCTAATTCAGAAACCATCC -> TCTAATTCAGAAACCATCCA
TAACTCTCCCCCTGTTGATC -> AACTCTCCCCCTGTTGATCA
TGTAGAGATACTGGTTACAT -> GTAGAGATACTGGTTACATA
AATGGAACCAATACAATTCA -> ATGGAACCAATACAATTCAT
CTGTCACTGGTAAATACGAG -> TGTCACTGGTAAATACGAGT
TACAGCAGGCCATTGGAGGT -> ACAGCAGGCCATTGGAGGTC
CTTAAACGGCTGTAACTCTC -> TTAAACGGCTGTAACTCTCC
TCAGATCGGGAGGTACGTCA -> CAGATCGGGAGGTACGTCAT
AGGCTGATCCGAGCATTATC -> GGCTGATCCGAGCATTATCG
GTCGGATACAGCAGGCCATT -> TCGGATACAGCAGGCCATTG
GTTTCTCTTGCCTGCGACTG -> TTTCTCTTGCCTGCGACTGA
ACTCCCGGAGAACAGGTATC -> CTCCCGGAGAACAGGTATCG
TACTATGTTAATCTTCTCAA -> ACTATGTTAATCTTCTCAAT
AAGTATGGAAGGAAGCTACT -> AGTATGGAAGGAAGCTACTA
ATGTGACGCCAAAAGGCGTT -> TGTGACGCCAAAAGGCGTTC
CACCCGCTTGATCCCAATTT -> ACCCGCTTGATCCCAATTTA
GACTCGGCCTCTTGGTACAG -> ACTCGGCCTCTTGGTACAGA
TTGTAACTCCCGGAGAACAG -> TGTAACTCCCGGAGAACAGG
AGCTCCCTGTCGGCTCTATT -> GCTCCCTGTCGGCTCTATTA
CTCTCCCCCTGTTGATCAGA -> TCTCCCCCTGTTGATCAGAT
ATACCAAACTCGGTCCTCCG -> TACCAAACTCGGTCCTCCGC
GCCGTACAGTGAGGGCAATC -> CCGTACAGTGAGGGCAATCC
TTGCCTGCGACTGAAGATAA -> TGCCTGCGACTGAAGATAAG
GTAGCGATGTCGGATACAGC -> TAGCGATGTCGGATACAGCA
TTTTACCACCTTGCACTGGG -> TTTACCACCTTGCACTGGGT
TACGAGGGTGCGAGCTGTCG -> ACGAGGGTGCGAGCTGTCGT
CAATTTATAACCCACCCCCC -> AATTTATAACCCACCCCCCT
CCCGCTTGATCCCAATTTAT -> CCGCTTGATCCCAATTTATA
CACGTTTGAAGGTTCTTCCG -> ACGTTTGAAGGTTCTTCCGG
TGAGCATCGAATAGCCCCTA -> GAGCATCGAATAGCCCCTAT
GCCCACTTCTGTCACTGGTA -> CCCACTTCTGTCACTGGTAA
TACATAATCCATCACTTGAT -> ACATAATCCATCACTTGATT
GTGTGCAAAATTAGGCTAGG -> TGTGCAAAATTAGGCTAGGC
GGGACGAAGTATGGAAGGAA -> GGACGAAGTATGGAAGGAAG
ATGACATCATGGTCAGCGTG -> TGACATCATGGTCAGCGTGA
CGCCCAGCTGACTCATAAAC -> GCCCAGCTGACTCATAAACT
TATTCCTGAGGCAGCTCTTA -> ATTCCTGAGGCAGCTCTTAA
CTGGTTACATACGAGGGTGC -> TGGTTACATACGAGGGTGCG
TTGGAGGTCACTCTGCTAAT -> TGGAGGTCACTCTGCTAATG
TCATAAACTCGAAGCTCCCT -> CATAAACTCGAAGCTCCCTG
GTCCGTAAAATTCCGATAGC -> TCCGTAAAATTCCGATAGCC
TGTCACCCCGTCCGTAAAAT -> GTCACCCCGTCCGTAAAATT
ACTCGGTCCTCCGCATATTC -> CTCGGTCCTCCGCATATTCC
ACCCACCCCCCTTGTAACTC -> CCCACCCCCCTTGTAACTCC
TGTTCATGAATGGCTACCGG -> GTTCATGAATGGCTACCGGG
GTCAAAACTATGTGACGCCA -> TCAAAACTATGTGACGCCAA
TCCCTGTCGGCTCTATTAGC -> CCCTGTCGGCTCTATTAGCC
CATAATCCATCACTTGATTA -> ATAATCCATCACTTGATTAA
TACGTCATGTGAGGCCAAGT -> ACGTCATGTGAGGCCAAGTG
TATGTTAATCTTCTCAATCA -> ATGTTAATCTTCTCAATCAC
CGCCTTAAGTGTACTTCGGT -> GCCTTAAGTGTACTTCGGTC
CCAAACTCGGTCCTCCGCAT -> CAAACTCGGTCCTCCGCATA
TATCAGATTAGATGTCACCC -> ATCAGATTAGATGTCACCCC
TTCTGTTCATGAATGGCTAC -> TCTGTTCATGAATGGCTACC
